src	gpt_3_5_trans	gpt_4o_trans	ollama_trans
JMM says Soren's helicopter take off delayed over PM's security protocol, writes to President Murmu	JMM म्हणते की सोरेनच्या हेलिकॉप्टरची प्रधानमंत्रीच्या सुरक्षा कायद्यांच्या कारणे उड्वा सुस्पष्ट झाली, राष्ट्रपती मुर्मूला लिहिते	JMM म्हणते की सोरेन यांच्या हेलिकॉप्टरचे उड्डाण PM यांच्या सुरक्षा प्रोटोकॉलमुळे विलंबित झाले, राष्ट्रपती मुर्मू यांना पत्र लिहिले.	जेएमएम सोरेनच्या हेलिकॉप्टरचा उड्डाण विलंब पीएमच्या सुरक्षा प्रोटोकॉलमुळे, राष्ट्रपती मुर्मू यांना पत्र लिहिले.
The king who defied the British: Uncovering the tale of Pazhassi raja’s rebellion	ब्रिटिशांच्या विरुद्ध कायमच्या असलेल्या राजाची गोडी: पाझासी राजाच्या विद्रोहाची कथा उघड्या	ब्रिटिशांना ज्या राजाने आव्हान दिले: पझ्हासी राजांच्या बंडाची कथा उलगडताना	ब्रिटिशांना आव्हान देणारा राजा: पझास्सी राजाच्या बंडाची कथा उघड करत आहे
Vinesh Phogat's retirement U-turn predicted after her latest Instagram post creates buzz on social media	विनेश फोगाटच्या नवीन इंस्टाग्राम पोस्टनंतर तिचा सोशल मीडियावर उतार-चढाव उत्पन्न करणारी तिची निवृत्तीची उतार की अंदाजित केली जाते.	विनेश फोगाटच्या निवृत्तीचा निर्णय बदलण्याचा अंदाज, तिच्या नव्या इंस्टाग्राम पोस्टनंतर सोशल मीडियावर चर्चा निर्माण झाली.	विनेश फोगाटचा निवृत्तीचा वळण फेरफार सोशल मीडियावरील ताज्या इंस्टाग्राम पोस्टने चर्चेत आला आहे.
The Pennsylvania push: Kamala Harris, Donald Trump spend final campaign hours in swing state	पेन्सिल्व्हेनिया पुश: कमला हॅरिस, डोनाल्ड ट्रंप स्विंग राज्यातील अंतिम उपयोग घंटेत व्यतीत करतात.	पेनसिल्व्हेनिया धक्का: कमला हॅरिस, डोनाल्ड ट्रम्प स्विंग राज्यात अंतिम प्रचार तास घालवतात।	पेन्सिल्व्हानिया धक्का: कामाला हॅरिस, डोनाल्ड ट्रम्प स्विंग स्टेटमध्ये अंतिम प्रचार तास व्यतीत करतात
Delhi engulfed in smog, toxic foam in Yamuna: Pics that capture national capital's pollution woes	धुंदात डुली लागलेले दिल्ली, यमुना नदीत विषाक्त फोम: राष्ट्रीय राजधानीची प्रदूषणाची विचारांवळी आकडेवारी	दिल्ली धुरळ्यात गढलेली, यमुनेत विषारी फेस: राष्ट्रीय राजधानीच्या प्रदूषणाच्या समस्या दर्शवणारे फोटो	दिल्ली स्मॉगने वेढली, यमुनेत विषारी फोम: राष्ट्रीय राजधानीच्या प्रदूषणाच्या वेदना टिपणाऱ्या छायाचित्रे
Will Muslim boycott of Kamala send Trump to the White House?	कमाला ची मुस्लिम बॉयकॉट ट्रंपला व्हाइट हाउसमध्ये पाठवेल का?	"""मुस्लिमांचा कमला विरोध ट्रम्प यांना व्हाइट हाऊसकडे पाठवेल का?"""	कमाला ला मुस्लिमांचा बहिष्कार ट्रंपला व्हाइट हाउसवर पाठवेल का?
Why Indian batters are struggling against left-arm spin	का भारतीय बॅट्समन्स डावीकडीच्या स्पिनर्सविरुद्ध कठीणतेने लढत आहेत?	भारतीय फलंदाज डावखुऱ्या फिरकी गोलंदाजीविरुद्ध का संघर्ष करत आहेत?	भारतीय बॅट्समॅन लेफ्ट-आर्म स्पिन विरुद्ध का संघर्ष करत आहेत?
JD Vance calls Kamala Harris 'trash' at Atlanta rally: 'In 2 days we're taking out the garbage'	जे डी व्हॅन्स अटलांटा रॅलीत कमला हॅरिसला 'कचरा' म्हणून बोलतो: '२ दिवसांत आम्ही कचरा बाहेर काढणार आहोत'	JD वॅन्स यांनी अटलांटामधील सभेत कमला हॅरिस यांना 'कचरा' म्हटले: '२ दिवसांत आपण हा कचरा बाहेर काढू'	जेड व्हान्स अटलांटा रॅलीमध्ये कमला हॅरिसला 'कचरा' म्हणतो: '२ दिवसांत आम्ही कचरा काढून टाकतो'
Meghan and Harry feel life in US hasn't been what they expected: Ex-staff	मेघन आणि हॅरीने अनुमान केलेल्याप्रमाणे अमेरिकेत जीवन त्यांना अपेक्षित काहीही नसलेलं वाटतं: पूर्व कर्मचारी	मेघन आणि हॅरी यांना वाटते की अमेरिकेतले जीवन त्यांच्या अपेक्षेप्रमाणे नाही: माजी कर्मचारी	मेगन आणि हॅरी यांना अमेरिकेतील आयुष्य त्यांच्या अपेक्षेप्रमाणे नाही: माजी स्टाफ
Elon Musk reacts to reports that he could be deported for immigration violation	इलॉन मस्कांनी प्रवासाच्या उल्लंघनासाठी तोडण्यात आल्याची अहवालांवर प्रतिसाद दिला.	"""इमिग्रेशन कायद्याचे उल्लंघन केल्याबद्दल त्याला देशातून हाकलले जाऊ शकते अशा अहवालांवर एलॉन मस्क यांची प्रतिक्रिया"""	एलोन मस्क इमिग्रेशन उल्लंघनासाठी निर्वासित होण्याच्या अहवालांना प्रतिक्रिया देत आहे.
How China is lessening its reliance on helium sourced from US	चीन कसे अमेरिकेतून हेलियमची आधी घटिकी कमी करीत आहे?	चीन अमेरिकेतून मिळणाऱ्या हिलियमवरील आपला अवलंब कमी कसा करत आहे.	चीन अमेरिकेकडून मिळवलेल्या हीलियमवरील अवलंबन कमी करीत आहे.
Kindle Colorsoft owners complain of a yellow bar on the e-reader’s screen	Kindle Colorsoft मालकांनी e-reader च्या पर्द्यावर एक पिवळा बार असल्याची फिरकी केली आहे	किंडल कलर्सॉफ्टच्या मालकांनी ई-रीडरच्या स्क्रीनवर पिवळ्या पट्टीची तक्रार केली आहे.	किंडल कलरसॉफ्ट मालकांना ई-रीडरच्या स्क्रीनवर पिवळा बार येतो अशी तक्रार आहे.
Nvidia and its partners built a sophisticated system to bypass U.S. restrictions on exporting AI chips to the Middle East, Russia, and China.	न्विडिया आणि त्यांचे साथी निर्माण केलेल्या एक उन्नत प्रणालीद्वारे युएससाठी AI चिप्सना मध्य पूर्व, रशिया आणि चीनमध्ये निर्यात करण्याच्या प्रतिबंधांना तरफ देण्यासाठी एक प्रणाली तयार केली.	Nvidia आणि त्याचे भागीदारांनी मध्य पूर्व, रशिया आणि चीनला AI चिप्स निर्यात करण्यावर अमेरिकेने लावलेल्या निर्बंधांना बगल देण्यासाठी एक अत्याधुनिक प्रणाली तयार केली.	एनविडिया आणि त्याचे भागीदारांनी अमेरिकेच्या निर्यातीवरील निर्बंधांना टाळून मध्यपूर्व, रशिया आणि चीनला एआय चिप्स पुरविण्यासाठी एक सुसूत्र प्रणाली बांधली.
The funding, which will top up the firm’s flagship fund, will be raised primarily from institutional investors. 	निधी, ज्याने कंपनीचे प्रमुख निधी वाढवणार आहे, प्राथमिकत: संस्थागत निवेशकांकडून जमा केले जाईल.	या निधीचे, जो कंपनीच्या प्रमुख निधीला वाढवेल, मुख्यतः संस्थात्मक गुंतवणूकदारांकडून संकलन केले जाईल.	कंपनीच्या प्रमुख निधीसाठी हे निधी संकलन मुख्यतः संस्थात्मक गुंतवणूकदारांकडून केले जाईल.
US Forest Service Decision to Halt Prescribed Burns in California is History Repeating	कॅलिफोर्नियातील पुरावयाच्या दहशतवाद्यांना थांबविण्याच्या संबंधात यूएस वन सेवेचा निर्णय इतिहासात पुन्हा दोहरणारं आहे.	कॅलिफोर्नियामध्ये नियोजित जाळपण थांबवण्याचा अमेरिकी वन सेवेचा निर्णय म्हणजे इतिहासाची पुनरावृत्ती आहे.	कॅलिफोर्नियामध्ये नियोजित अग्नी स्थगित करण्याचा अमेरिकन फॉरेस्ट सेवा निर्णय म्हणजे इतिहासाची पुनरावृत्ती
The man who gave us the solution to the Entscheidungsproblem	आपल्याला Entscheidungsproblem ची त्यांनी समाधान दिलेला व्यक्ती	ज्या माणसाने आम्हाला एंटशाइडुंग्सप्रोब्लेमचे समाधान दिले.	मनुष्य ज्याने आम्हाला Entscheidungsproblem चे उत्तर दिले.
The shift in policy, covering government agencies and contractors working on national security, is intended to promote “responsible and ethical” innovations, the company said.	नाशिका आणि ठरवावर काम करणारे सरकारी विभाग आणि कंट्रॅक्टर्सवरील धोरणात झालेली बदलण त्यांनी उचित आणि नैतिक नवीनतेला प्रोत्साहित करण्याचा उद्दिष्ट आहे, कंपनीने म्हणाले.	"या धोरणातील बदलाचा उद्देश राष्ट्रीय सुरक्षेवर काम करणाऱ्या सरकारी एजन्सी आणि कंत्राटदारांना व्यापणे आणि ""जबाबदार आणि नैतिक"" नवकल्पना प्रोत्साहित करणे आहे, असे कंपनीने म्हटले आहे."	"राष्ट्रीय सुरक्षेसाठी काम करणाऱ्या सरकारी एजंसी आणि कंत्राटदारांना व्याप्त करणारी धोरणातील बदल, ""उत्तरदायी आणि नैतिक"" नवकल्पना प्रोत्साहन देण्यासाठी कंपनीने सांगितले."
China reveals a new heavy lift rocket that is a clone of SpaceX’s Starship	चीनने SpaceX च्या स्टारशिपच्या क्लोन असा नवा हेवी लिफ्ट रॉकेट लॉन्च केला.	चीनने एक नवीन हेवी लिफ्ट रॉकेट सादर केले आहे, जे स्पेसएक्सच्या स्टारशिपचे प्रतिरूप आहे.	चीनाने स्पेसएक्सच्या स्टारशिपची प्रतिकृती असलेला नवा भारी उड्डाण रॉकेट उघडकीस आणला.
Singapore requires vehicle owners to bid for a set number of Certificates of Entitlement – costly operating permits valid for only ten years.	सिंगापूरमध्ये वाहन मालकांना व्हहिकल ऑफ एंटिटल्मेंटच्या एक संख्येक भरायची आवश्यकता आहे - केवळ दहा वर्षे सक्रिय असणारे महाग संचालन परवाने.	सिंगापूरमध्ये वाहन मालकांना मर्यादित संख्येच्या हक्काच्या प्रमाणपत्रांसाठी बोली लावावी लागते - हे महागडे ऑपरेटिंग परवाने फक्त दहा वर्षांसाठी वैध असतात.	सिंगापूरमध्ये वाहन मालकांना दहा वर्षांच्या कालावधीसाठी वैध असलेल्या प्रमाणपत्रांच्या मालकीचा हक्क मिळविण्यासाठी बोली लावावी लागते.
The Hwasong-19 is North Korea’s biggest missile yet and its test comes during a time of notable tensions on the peninsula.	ह्वासोंग-19 हा उत्तर कोरियाचा सर्वात मोठा पातक आहे आणि त्याचे चाचणी धुरण्याच्या वेळी कोरियाच्या द्वीपावर लक्षात घेतले जाते.	ह्वासॉंग-१९ हे उत्तर कोरियाचे आतापर्यंतचे सर्वात मोठे क्षेपणास्त्र आहे आणि त्याची चाचणी द्वीपकल्पावरील उल्लेखनीय तणावाच्या काळात होत आहे.	ह्वासोंग-१९ हा उत्तर कोरियाचा आतापर्यंतचा सगळ्यात मोठा मिसाइल आहे आणि त्याची चाचणी पेनिन्सुलावरील उल्लेखनीय तणावाच्या काळात होत आहे.
The species may have been carried to the Sacramento–San Joaquin Delta in ballast water on ships	ई प्रजाती सुधारणा जलमाल्मतेच्या संकेतस्थळावर सेन्ट्रामेंटो-सॅन जोआक्विन डेल्टात जलभरणाद्वारे जाहिर केली जाऊ शकते.	ही प्रजाती जहाजांच्या बॅलस्ट पाण्यामध्ये सॅक्रामेंटो-सॅन जोआक्विन डेल्टा पर्यंत पोहोचवली गेली असू शकते.	जाती शिप्सच्या बॅलस्ट वॉटरमध्ये सॅक्रामेंटो-सॅन जोआक्विन डेल्टामध्ये नेली गेली असण्याची शक्यता आहे.
Discovery partnered with PR firm Relevance International to produce ultra-luxury experiences and products under the banner of fictionaire billionaire Bruce Wayne’s conglomerate.	डिस्कव्हरीने एक पीआर फर्म रिलेवन्स इंटरनॅशनलसह सामाजिक बिल्डर ब्रूस वेनच्या संघटनेच्या ध्वनितीवादी बिल्योनेअर ब्रूस वेनच्या बॅनराखाली अल्ट्रा-लक्झरी अनुभवे आणि उत्पादने उत्पादित करण्यासाठी साथीत्व केले.	डिस्कव्हरीने पीआर फर्म रिलेव्हन्स इंटरनॅशनलसोबत भागीदारी केली आहे ज्याअंतर्गत काल्पनिक अब्जाधीश ब्रूस वेनच्या समूहाच्या नावाखाली अल्ट्रा-लक्झरी अनुभव आणि उत्पादने तयार केली जातील.	डिस्कव्हरीने फिक्शनेर बिलियनेर ब्रुस वेनच्या काँग्लोमरेटच्या बॅनरखाली अल्ट्रा-लक्झरी अनुभव आणि उत्पादने तयार करण्यासाठी रिलेव्हन्स इंटरनॅशनल या पीआर फर्मच्या साथीने भागीदारी केली.
Water utilities and chemical manufacturers are challenging the new EPA standards. 	पाणी उपयोग करणारे व रासायनिक निर्माते नवीन EPA मानकांवर आपत्ती जाहिर करत आहेत.	पाणी उपयोगिता कंपन्या आणि रासायनिक उत्पादक नवीन EPA मानकांना आव्हान देत आहेत.	नवीन ईपीए मानकांना पाणी सुविधा आणि रासायनिक उत्पादक कंपन्या आव्हान देत आहेत.
A radio station in Poland fired its on-air talent and brought in A.I.-generated presenters. An outcry over a purported chat with a Nobel laureate quickly ended that experiment.	पोलंडमधील एक रेडिओ स्टेशनने त्याचे ऑन-एअर प्रतिभा काढून आय-आय-संचालित प्रस्तुतकर्ते घेतली. नोबेल पुरस्कारीसह संभाषणाच्या दाव्यावर उत्तर देणारं चर्चा करून लवकरात तो प्रयोग समाप्त केलं.	पोलंडमधील एका रेडिओ स्टेशनने त्याच्या ऑन-एअर टॅलेंटला कामावरून काढले आणि ए.आय.-निर्मित प्रस्तुतकर्त्यांना आणले. एका नोबेल पारितोषिक विजेत्यासोबतच्या कथित गप्पांवर झालेल्या आक्रोशामुळे तो प्रयोग लवकरच संपुष्टात आला.	पोलंडमधील एक रेडिओ स्टेशनने त्याचे ऑन-एअर टॅलेंट काढून टाकले आणि ए.आय.-जनरेटेड सादरकर्ते आणले. नोबेल पुरस्कार विजेत्याशी झालेल्या संभाव्य चेटच्या निषेधाने त्या प्रयोगाला लवकरच संपवले.
From infancy, children show heightened interest in events that are impossible or improbable, relative to likely events.	बालपणापासून, मुलांनी संभाव्य किंवा असंभाव्य घटनांवर चांगली आकर्षणाची दर्जा दाखवतात.	लहानपणापासूनच मुले अशक्य किंवा अशक्यप्राय घटनांमध्ये, शक्य घटनांच्या तुलनेत, अधिक रस दाखवतात.	बालपणापासूनच मुले असंभव किंवाल्पसंभव घटनांवर अधिक रस दाखवतात, संभाव्य घटनांच्या तुलनेत.
Four persons were referred to hospital and the rest were treated as outpatients at the event venue, police sources said.	चार व्यक्ती रुग्णालयात सुचवले गेले आणि इतर सर्वांना पोलिस स्रोतांनी कार्यक्रमाच्या स्थळी बाह्य उपचार दिले.	चार जणांना रुग्णालयात पाठवण्यात आले आणि उर्वरितांना कार्यक्रमाच्या ठिकाणी बाह्यरुग्ण म्हणून उपचार करण्यात आले, असे पोलिस सूत्रांनी सांगितले.	चार व्यक्ती रुग्णालयात दाखल करण्यात आले आणि उर्वरीतांना स्थानिक स्थळावर OPD म्हणून व्यवहार करण्यात आला, पोलीस सूत्रांनी सांगितले.
During investigation, the Washermenpet police found that he was attacked by three persons with stones and beer bottles while he was consuming alcohol.	तपासणी काळात, वाशर्मेनपेट पोलीसांनी त्यांना एका व्यक्तीने व्हिस्की प्यायला असताना किमान तीन व्यक्तींद्वारे पाण्याच्या पातळ्या आणि बियरच्या बोतलांनी हल्ला केलेल्या मिळालेल्या आहे.	चौकशीदरम्यान वॉशरमेनपेट पोलिसांना आढळले की, तो मद्यपान करत असताना त्याच्यावर तीन जणांनी दगड आणि बिअरच्या बाटल्यांनी हल्ला केला.	चौकशीत, वाशेरमेनपेट पोलिसांनी असे आढळले की त्याला तीन जणांनी दगड आणि बियरच्या बॉटलनी तो मद्यपान करत असताना हल्ला केला.
Two juvenile boys who were lodged at the Government Observation Home in Chengalpattu escaped on Tuesday night.	बुधवार रात्री चेंगलपट्टूतील सरकारी अवलोकन घरात राहून असलेले दोन अल्पकालीन मुलगे मागच्या रात्री फरार झाले.	चेंगलपट्टू येथील सरकारी निरीक्षणगृहात ठेवलेले दोन अल्पवयीन मुले मंगळवारी रात्री पळून गेली.	चेंगलपट्टुमधील सरकारी निरीक्षण गृहात ठेवण्यात आलेले दोन किशोर मुले मंगळवारी रात्री पलायन करून गेली.
During Mr. Gandhi’s Srinagar stay, men disembarked from cars on Boulevard road to hug him.	मि. गांधींच्या स्रीनगर वसंतात, बुलेवार्ड रोडवरील कारमधून लोक मिळवण्यासाठी खाली उतरले.	श्री गांधींच्या श्रीनगर दौऱ्यादरम्यान, बुलेवर्ड रोडवर गाड्यांमधून उतरून लोकांनी त्यांना आलिंगन दिले.	श्री गांधीजी स्रीनगरमध्ये राहात असताना बुलेवार्ड रोडवरून कारून उतरून त्यांना मिठी मारायचे.
They alleged that several brick kilns started selling old stocks of bricks from Wednesday after paying the first instalment of the fine levied on them by the Geology and Mining Department.	त्यांनी दावा केला की काही ईंटीचे उत्पादन बंद करून घेतले होते, ज्याला त्यांना भूवैज्ञानिक आणि खाण विभागाने लागू केलेल्या मोटीच्या प्रथम किंमतीवरील अंशाचे भुकतान करून देत आहेत.	त्यांनी असा आरोप केला की, भूमिज आणि खनिज विभागाने त्यांच्यावर लावलेला दंडाचा पहिला हप्ता भरल्यानंतर काही वीटभट्ट्यांनी बुधवारी जुने वीटसाठे विकायला सुरुवात केली.	ते म्हणाले की बुधवारापासून अनेक इट्टे भट्ट्या ज्या वर्गणीचा पहिला हप्ता जिल्हा भूविज्ञान व खनिकर्म विभागाकडून त्यांच्यावर लावला गेला होता त्यानंतर जुन्या साठ्यातील इट्ट्यांची विक्री करू लागल्या.
Ten Indian career diplomats, who are High Commissioners or Ambassadors of India in other countries, called on Governor R.N. Ravi at the Raj Bhavan in Chennai on Monday.	भारतातील इतर देशांमध्ये भारताचे उच्च आयुक्त किंवा राजदूत असलेले दहा भारतीय पेशेवर राजनयिके सोमवारी राज भवनात गवर्नर आर.एन. रवींना भेट दिली.	सोमवारी चेन्नई येथील राजभवनात भारताचे उच्चायुक्त किंवा राजदूत असलेल्या दहा भारतीय करिअर राजनैतिकांनी राज्यपाल आर.एन. रवी यांची भेट घेतली.	दहा भारतीय कारकून राजदूत, जे इतर देशांमध्ये भारताचे उच्चायुक्त किंवा राजदूत आहेत, सोमवारी चेन्नई येथील राजभवनात राज्यपाल आर.एन. रवी यांची भेट घेतली.
However, Dr. Hande, who wrote the foreword for her book and took part in some of these Assembly debates, says Muthu discharged her duty efficiently as a Minister with no room for corruption.	पण, डॉ. हंडे, ज्यांनी तिच्या पुस्तकासाठी आधारांभ लिहिली होती आणि ह्या सभेत काही भाग घेतलं होतं, म्हणजे मुथू मंत्रीस्थानावर कोरप्शनसाठी जागा न राहून तिची कार्यक्षमता अधिकृत दिली, असे म्हणतात डॉ. हंडे.	तथापि, डॉ. हांडे, ज्यांनी त्यांच्या पुस्तकासाठी प्रस्तावना लिहिली आणि या विधानसभेतील काही चर्चांमध्ये भाग घेतला, म्हणतात की मुथु यांनी एक मंत्री म्हणून आपले कर्तव्य कार्यक्षमतेने पार पाडले आणि भ्रष्टाचाराला कोणतीही जागा दिली नाही.	पण डॉक्टर हांडे ज्यांनी तिच्या पुस्तकासाठी प्रस्तावना लिहिली आणि या विधानसभा चर्चेत सहभागी झाले, ते म्हणतात की मुत्तू मंत्री म्हणून तिचे कर्तव्य कुशलतेने पार पाडले आणि भ्रष्टाचारासाठी कोणतीही जागा नव्हती.
While both Mr. Lobo and Mr. Kamat have cited disaffection with the Congress high command as reasons, the true reasons are all too transparent.	माझा लोबो आणि माझा कामत यांनी दोन्हीतरी आम्हाला काँग्रेसच्या मुख्य कमाण्डविरुद्धाचा अनामिकीत्र देतला तरी सच्चे कारण अत्यंत पारदर्शक आहेत.	"""श्री. लोबो आणि श्री. कामत या दोघांनीही काँग्रेसच्या उच्च कमांडबद्दलची असंतोषता कारणे म्हणून उद्धृत केली आहे, परंतु खरे कारणे सर्वांनाच स्पष्ट आहेत."""	लोबो साहेब आणि कामत साहेब दोघेही काँग्रेसच्या उच्च नेतृत्वाबद्दल नाराजी म्हणून कारणे देत आहेत, पण खरे कारणे स्पष्टच आहेत.
The first festival celebrating the linguistic and cultural ties between the Barak Valley region of Assam and the Sylhet segment of Bangladesh began on Friday evening.	पहिल्याचा उत्सव शुक्रवार रात्रीपासून आसामच्या बाराक व्हॅली विभाग आणि बांग्लादेशच्या सिलहेट विभागातील भाषाकीय आणि सांस्कृतिक संबंधांचा साजरा करण्याचा सुरवात झाला.	आसामच्या बराक खोऱ्याचा प्रदेश आणि बांगलादेशातील सिल्हेट विभाग यांच्यातील भाषिक आणि सांस्कृतिक संबंध साजरे करणारा पहिला उत्सव शुक्रवार संध्याकाळी सुरू झाला.	आसामच्या बाराक व्हॅली प्रदेश आणि बांगलादेशच्या सिलहट विभागातील भाषिक आणि सांस्कृतिक संबंध साजरे करणारा पहिला उत्सव शुक्रवार संध्याकाळी सुरू झाला.
The objective of such markets is to incentivise investments in renewable energy sources.	अशा बाजारांचा उद्दिष्ट नवीन ऊर्जा स्रोतांमध्ये निवेश करण्यासाठी प्रेरित करणे आहे.	अशा बाजारांचे उद्दिष्ट नवीकरणीय ऊर्जा स्रोतांमध्ये गुंतवणूक प्रोत्साहित करणे आहे.	अशा बाजारपेठांचे उद्दिष्ट नवीकरणीय ऊर्जा स्रोतांमध्ये गुंतवणूक करण्यास प्रोत्साहन देणे आहे.
The Centre is expected to clarify, later this year, the specifics of a carbon trading market in India.	केंद्राची अपेक्षा आहे की भारतातील कार्बन व्यापाराच्या विशिष्टता वर्षातून नंतर स्पष्ट करेल.	यावर्षाच्या शेवटी केंद्र सरकारने भारतातील कार्बन व्यापार बाजाराच्या विशिष्ट बाबींवर स्पष्टीकरण देणे अपेक्षित आहे.	यावर्षी उशीरा केंद्राने भारतातील कार्बन व्यापार बाजाराच्या तपशीलांवर स्पष्टीकरण देण्याची अपेक्षा आहे.
Hydrogen is an essential industrial fuel that has a range of uses from producing ammonia.	हायड्रोजन हा महत्वाचा औद्योगिक ईंधन आहे ज्याचा वापर अमोनिया उत्पादनाच्या प्रमाणातून आहे.	हायड्रोजन हे एक अत्यावश्यक औद्योगिक इंधन आहे ज्याचा अमोनिया तयार करण्यापासून विविध उपयोग आहे.	हायड्रोजन हे औद्योगिक इंधन आहे ज्याचा वापर अमोनिया तयार करण्यासाठी अनेक प्रकारे होतो.
Finance Minister Nirmala Sitharaman on Saturday said that regulators would do their job.	वित्त मंत्री निर्मला सीतारमण शनिवारी यांनी म्हणाली की नियंत्रकांनी आपले काम करेल.	शनिवारी अर्थमंत्री निर्मला सीतारामन यांनी सांगितले की नियामक त्यांचे काम करतील.	शनिवारी अर्थमंत्री निर्मला सीतारामन यांनी सांगितले की नियामक त्यांचे काम करणार आहेत.
Madras has received a grant of ₹242 crore to do research on laboratory-grown diamonds.	मद्रासला ₹२४२ कोटीची संबंधन दिली गेली आहे ज्यामध्ये प्रयोगशाळेत वाढविलेले हीरे वर्गवाढ करण्याचे गव्हार आहे.	मद्रासला प्रयोगशाळेत पिकवलेल्या हिऱ्यांवर संशोधन करण्यासाठी ₹242 कोटींचा अनुदान प्राप्त झाला आहे.	मद्रासला लॅबोरेटरी-वाढलेल्या हिरवळींवर संशोधन करण्यासाठी २४२ कोटी रुपयांचा अनुदान मिळाला आहे.
Before Rao took leave after the meeting, MGR gently reminded him of the Cauvery water.	बैठकनंतर रावॉ लवकर घेण्यास जाताना, एमजीआरने त्याला कावेरीच्या पाण्याबद्दल अडचणीत लाॅवली.	राव बैठकीनंतर निघण्याआधी, एमजीआरने त्याला कोरी नदीच्या पाण्याविषयी सौम्यपणे आठवण करून दिली.	भेटीनंतर राव सुट्टी घेण्यापूर्वी, एमजीआरने कावेरी पाण्याबद्दल त्याला मृदू स्मरण केले.
It is because of this initiative that Tamil Nadu became the centre of higher learning.	ह्या प्रयत्नाच्या कारणे तमिळनाडू उच्च शिक्षणाचे केंद्र झाले.	याच उपक्रमामुळे तामिळनाडू उच्च शिक्षणाचे केंद्र बनले.	हे प्रारंभिक कार्यामुळे तमिळनाडू उच्च शिक्षणाचे केंद्र बनले.
However, within minutes after the then Prime Minister intervened.	तरीही, त्याच्यानंतर केल्यानंतर पंतप्रधान बंदिशास सहाय्य केला.	तथापि, तत्काळीन पंतप्रधानांनी हस्तक्षेप केल्यानंतर काही मिनिटांतच.	मात्र त्या वेळी पंतप्रधानांनी हस्तक्षेप केल्यानंतर काही मिनिटांत.
The initial shock following the Taliban’s seizure of power in Kabul is waning.	काबुलमध्ये तालिबानच्या शक्तीचे वशाधिकाराच्या नंतरच्या प्रारंभिक अचंतेचा क्षणिक आहे.	काबुलमध्ये तालिबानने सत्ता हस्तगत केल्यानंतरचा प्रारंभिक धक्का कमी होत आहे.	काबुलमध्ये तालिबानच्या सत्ता हस्तगतीनंतरच्या सुरुवातीच्या धक्क्याचा प्रभाव कमी होत आहे.
The greatest impact of denial of rights for women in the workforce would be a sharp contraction in the economy.	कामातील महिलांना हक्क नकारण्याचा सर्वात मोठा परिणाम अर्थव्यवस्थेत कठोर कुंपकारणारा असेल.	कामकाजाच्या ठिकाणी महिलांच्या हक्कांच्या नाकारण्याचा सर्वात मोठा परिणाम म्हणजे अर्थव्यवस्थेत तीव्र संकुचन होईल.	महिलांना कामाच्या ठिकाणी हक्कांचे नाकारणे हे अर्थव्यवस्थेवर सर्वात मोठा परिणाम असा की अर्थव्यवस्था अचानक संकुचित होईल.
The Taliban do not shy from leveraging the issue to gain international attention.	टालिबान अंतरराष्ट्रीय लक्षात येण्याच्या कार्यात विषयाचा उपयोग करण्यास लज्जित होत नाहीत.	तालिबान या मुद्द्याचा आंतरराष्ट्रीय लक्ष वेधण्यासाठी उपयोग करण्यात मागे हटत नाहीत.	तालिबान आंतरराष्ट्रीय लक्ष वेध घेण्यासाठी या मुद्द्याचा फायदा घेण्यापासून पळत नाहीत.
In Jammu and Kashmir, the enrolment dropped sharply from 1.78 lakh in 2019-20 to 1.31 lakh in 2020-21.	जम्मू आणि काश्मीरमध्ये, २०१९-२० मध्ये १.७८ लाख विद्यार्थीची नोंदणी २०२०-२१ मध्ये १.३१ लाख वर्षात थेट कमी झाली.	जम्मू आणि काश्मीरमध्ये, २०१९-२० मध्ये १.७८ लाखांवरून २०२०-२१ मध्ये १.३१ लाखांपर्यंत नोंदणी तीव्रपणे कमी झाली.	जम्मू आणि काश्मीरमध्ये, २०१९-२० मध्ये १.७८ लाख वरून २०२०-२१ मध्ये १.३१ लाख पर्यंत नोंदणी तीव्रपणे घटली.
Senior advocate Meenakshi Arora made the oral mentioning for early hearing.	वरिष्ठ वकील मीनाक्षी आरोरा शीघ्र सुनवाईसाठी मौखिक उल्लेख केले.	वरिष्ठ वकील मीनाक्षी अरोरा यांनी लवकर सुनावणीसाठी तोंडी विनंती केली.	वरिष्ठ वकील मीनाक्षी अरोरा यांनी लवकर सुनावणीसाठी तोंडी नोंदणी केली.
The State had never forced students out of State schools by restricting hijab.	राज्याने हिजाब रोकून राज्यकीय शाळांमध्ये विद्यार्थ्यांना बाहेर काढण्याचा कधीच प्रयत्न केला नव्हता.	राज्याने हिजाबवर निर्बंध लावून विद्यार्थ्यांना राज्य शाळांमधून कधीही बाहेर काढले नाही.	राज्याने कधीही राज्य शाळांमधून विद्यार्थ्यांना हिजाबच्या मर्यादेमुळे बाहेर काढले नाही.
The patient has the right to refuse to participate in such research projects.	रुग्णाला इतर संशोधन प्रकल्पांमध्ये सहभागी होण्याचे नाही, त्याला इंकार करण्याचा हक्क आहे.	रुग्णाला अशा संशोधन प्रकल्पांमध्ये सहभागी होण्यास नकार देण्याचा अधिकार आहे.	आसे संशोधन प्रकल्पात भाग घेण्यास नकार देण्याचा अधिकार रुग्णाला आहे.
The field officials should remember it while implementing projects. 	कार्यक्रमे कायम करताना क्षेत्रीय अधिकारींना ह्या गोष्टीला लक्षात ठेवाव्यात.	प्रकल्प अंमलबजावणी करताना क्षेत्रीय अधिकाऱ्यांनी हे लक्षात ठेवले पाहिजे.	प्रकल्प राबविताना क्षेत्र अधिकारी हे लक्षात ठेवावे.
Senior officials in the Ministry of Tribal Affairs said a change in the structure had already been approved.	आदिवासी कार्यमंत्रालयातील वरिष्ठ अधिकारी म्हणाले की संरचनेत बदल अद्यात already मंजूर झालेलं आहे.	आदिवासी कार्य मंत्रालयातील वरिष्ठ अधिकाऱ्यांनी सांगितले की, संरचनेत बदल करण्यास आधीच मान्यता देण्यात आली आहे.	आदिवासी कार्य मंत्रालयातील वरिष्ठ अधिकारी म्हणाले की संरचनेतील बदलाला आधीच मंजुरी मिळाली आहे.
The Bhagwan Mahaveer Foundation has called for applications for the Mahaveer awards.	भगवान महावीर फाउंडेशनने महावीर पुरस्कारांसाठी अर्जांची मागणी केली आहे.	भगवान महावीर फाउंडेशनने महावीर पुरस्कारांसाठी अर्ज मागवले आहेत.	भागवान महावीर फाउंडेशनने महावीर पुरस्कारांसाठी अर्ज मागितले आहेत.
Mr. Yediyurappa resigned as Chief Minister and was succeeded by Basavaraj Bommai in 2020.	श्री. येदियुरप्पा २०२० मध्ये मुख्यमंत्रीपदी पदस्थापित झाले आणि त्यांनी बासवराज बोम्मईवर पात्रतें केले.	श्री येडियुरप्पा यांनी मुख्यमंत्रिपदाचा राजीनामा दिला आणि 2020 मध्ये बसवराज बोम्मई यांनी त्यांची जागा घेतली.	श्री येडियुरप्पा यांनी मुख्यमंत्रीपदाचा राजीनामा दिला आणि २०२० मध्ये बसवराज बोम्मई यांनी त्यांची जागा घेतली.
The rescuers had to cut the roof of the lift to bring them out, and nobody was hurt.	उद्धारकारकांनी त्यांना बाहेर काढण्यासाठी लिफ्टच्या छत्रीवर कापणं करावं लागलं आणि कोणतेही जखमी झालेले नव्हते.	बचावकारांना त्यांना बाहेर आणण्यासाठी लिफ्टचे छत कापावे लागले, आणि कोणीही जखमी झाले नाही.	लिफ्टचा छत कापून त्यांना बाहेर काढावे लागले आणि कोणालाही इजा झाली नाही.
The group claimed another police station attack in Rask that killed one officer on January 10.	गटाने जानेवारी १० रोजी रास्कमध्ये एक पोलिस ठाण्यावर हल्ला केला आणि एक पोलिस अधिकारीला मारून टाकले असा दावा केला.	या गटाने रास्कमधील आणखी एका पोलिस ठाण्यावर केलेल्या हल्ल्याची जबाबदारी स्वीकारली ज्यामध्ये १० जानेवारी रोजी एक अधिकारी ठार झाला.	रास्क येथे १० जानेवारीला एका अधिकाऱ्याचा मृत्यू झालेला पोलीस स्टेशनवरील हल्ला देखील त्या गटाने कबूल केला.
Based on the complaint, an FIR has been registered against Constable Shailendra Singh and three other policemen.	दंडाधिकारी शैलेंद्र सिंग आणि तिने अडकलेल्या तिन्ही पोलीसांविरुद्ध एफआयआर दाखल केली आहे यावर आधारित.	तक्रारीच्या आधारे, हवालदार शैलेंद्र सिंग आणि इतर तीन पोलिसांविरुद्ध गुन्हा दाखल करण्यात आला आहे.	आपत्तीवरून, कॉन्स्टेबल शैलेंद्र सिंह आणि इतर तीन पोलीसांविरुद्ध एफआयआर नोंदवला आहे.
Financial institutions also play a crucial role in tracking the money trails sustaining these networks.	आर्थिक संस्थांनीही या नेटवर्कच्या चालू ठेवणार्या पैसाच्या ट्रेल्सची ट्रॅकिंग करण्यात महत्वाची भूमिका भाजतात.	वित्तीय संस्था देखील या नेटवर्क्सना टिकवून ठेवणाऱ्या पैशाच्या मागोवाचा मागोवा घेण्यात महत्त्वपूर्ण भूमिका बजावतात.	आर्थिक संस्थाने देखील या नेटवर्कच्या पोषणासाठी पैसा ट्रेल्स ट्रॅकिंगमध्ये महत्त्वाची भूमिका बजावतात.
It is laudable that customs duties have been waived on three anti-cancer drugs.	तीन एंटी-कॅन्सर औषधांवर वस्त्रापट्टी मोफत केल्याचं प्रशंसनीय आहे.	तीन कर्करोगविरोधी औषधांवरील सीमाशुल्क रद्द करण्यात आले आहे, हे प्रशंसनीय आहे.	तीन कर्करोग विरोधी औषधींवरील सीमा शुल्क माफ केले जाणे हे स्तुत्य आहे.
Inside the final sprint in the biggest battleground state on the map.	नक्कीच्या फायनल स्प्रिंटमध्ये नक्कीच्या भू-नक्षेत्रातील सर्वात मोठ्या मायदानात.	नकाशावरील सर्वात मोठ्या रणांगण राज्यातील अंतिम शर्यतीत.	नकाशावरील सर्वात मोठ्या लढाईच्या राज्यातील अंतिम स्प्रिंटच्या आत.
All eyes are on America as an uncertain world awaits election result.	सर्व दृष्टी अयमेरिकेला अदृश्य विश्व निवडणूकचा परिणाम वाटतो.	संपूर्ण जगाचे लक्ष अमेरिकेकडे आहे कारण एक अनिश्चित जग निवडणुकीच्या निकालाची वाट पाहत आहे.	अमेरिकेच्या निवडणुकीच्या निकालाची वाट पाहत अंशतः जगाचे सर्व डोळे अमेरिकेकडे लागले आहेत.
Twitch faces criticism over Israel-Gaza war content on platform.	ट्विचला त्यांच्या प्लॅटफॉर्मवर इस्राएल-गाझा युद्धाबद्दल टीका मिळते.	ट्विचला प्लॅटफॉर्मवरील इस्रायल-गाझा युद्धाच्या सामग्रीवर टीका केली जात आहे.	ट्विचवर इस्रायल-गाझा युद्ध संबंधित सामग्रीवर टीका स्वीकारली जात आहे.
North Korea fires multiple ballistic missiles toward the sea ahead of U.S. election.	उत्तर कोरिया यू.एस. निवडणुक्याच्या पूर्वी जलवायूक दिशेला कोल्हापाण्यात अनेक बॉलिस्टिक मिसाईल्स फोडते.	उत्तर कोरियाने अमेरिकेच्या निवडणुकीच्या आधी समुद्राकडे अनेक बॅलिस्टिक क्षेपणास्त्रे डागली.	उत्तर कोरियाने अमेरिकेच्या निवडणुकीच्या आधी समुद्राकडे अनेक बॅलिस्टिक मिसाइल्स फायर केल्या.
Singapore Airlines will add first class, revamp cabins for longest flights.	सिंगापूर एअरलाइंसने सर्वात सुप्रथम वर्ग जोडणार, दीर्घतम उड्डानांसाठी केबिनस सुधारणार.	सिंगापूर एअरलाइन्स सर्वात लांब उड्डाणांसाठी फर्स्ट क्लासची भर घालेल आणि केबिन्सचे नूतनीकरण करेल.	सिंगापूर एरलाइन्स लांबच्या प्रवासासाठी प्रथम वर्ग जोडेल आणि केबिन्सचा नवीनीकरण करेल.
Priyanka Chopra Jonas and Nick Jonas celebrate 'Diwaloween,' Diwali and Halloween mashup.	प्रियांका चोपडा जोनस आणि निक जोनस 'दिवालोवीन,' दिवाळी आणि हॅलोवीनचा मॅशअप साजरा करतात.	प्रियंका चोप्रा जोनास आणि निक जोनास 'दिवाळोवीन' साजरा करतात, जो दिवाळी आणि हॅलोवीन यांचा मिश्रण आहे.	प्रियांका चोप्रा जोनास आणि निक जोनास 'डिवालोवीन' साजरा करतात, दिवाळी आणि हॅलोवीनचा मिलाफ.
Pennsylvania officials denounce Halloween float appearing to depict Harris tied to golf cart.	पेन्सिल्व्हेनिया अधिकारी हॅलोव्हीन फ्लोटला हॅरिसला गोल्फ कार्टशी जोडून दर्शवणाऱ्या नक्कलीने खंडन केले.	पेन्सिल्व्हेनियातील अधिकाऱ्यांनी हॅलोविन फ्लोटवर हॅरिसला गोल्फ कार्टला बांधलेले दिसल्याचा निषेध केला.	पेन्सिल्व्हेनिया अधिकारी हॅलोवीन फ्लोटवर हॅरिसला गोल्फ कार्टशी बांधलेले दाखविणारे चित्र निषेध करतात.
Elon Musk's election-doubting posts shared 9 times more than his less extreme election content.	इलॉन मस्कच्या निवडणूकांच्या विश्वास संदेहाच्या पोस्ट्सने त्यांच्या कमी अतिरेकी निवडणूक सामग्रीपेक्षा ९ वेळा जास्त सामायिक केले.	इलॉन मस्क यांच्या निवडणुकीबाबत शंका उपस्थित करणाऱ्या पोस्ट्स त्यांच्या कमी तीव्र निवडणूक विषयक सामग्रीपेक्षा 9 पट अधिक वेळा शेअर केल्या गेल्या.	एलोन मस्कच्या निवडणूक-शंका पोस्ट्स त्याच्या कमी अति निवडणूक सामग्रीवर ९ पट जास्त सामायिक केल्या गेल्या.
Americans eye the economy from kitchen tables and hourly jobs as they plan their votes.	अमेरिकन लोक त्यांच्या मतदानाची योजना करताना रोजगाराच्या टेबलवरून आणि तासानुसार कामांपासून आक्षेप देतात.	अमेरिकन लोक अर्थव्यवस्थेकडे त्यांच्या स्वयंपाकघराच्या टेबलांवरून आणि तासिक नोकऱ्यांमधून पाहतात, जेव्हा ते त्यांच्या मतांची योजना करतात.	अमेरिकन्स किचन टेबल्स आणि तासिक नोकर्यांपासून अर्थव्यवस्थेकडे नजर ठेवतात जेव्हा ते मतदानाची योजना करतात.
Quincy Jones, musical maestro and entertainment industry titan, dies at 91.	क्विंसी जोन्स, संगीतकलाविद आणि मनोरंजन उद्योगाचे महानायक, 91 वर्षांच्या वयाने मराठी झाले.	क्विन्सी जोन्स, संगीत माहीर आणि मनोरंजन उद्योगातील दिग्गज, यांचे ९१ व्या वर्षी निधन.	क्विंसी जोन्स, संगीताचा मास्टरो आणि मनोरंजन उद्योगाचा दिग्गज, ९१ वर्षांचे वयात मृत्यू पावला.
Proud Boys claim they'll be at polling places as Trump ups violent rhetoric and fraud claims	गर्वित पुरुषांनी अभिमान दावा केला की ते मतदान स्थळांत उपस्थित राहतील, ज्यामुळे ट्रंप क्रुर भाषण आणि धोखाधडीच्या दाव्यांमध्ये वाढ होण्याचा दावा करतो.	प्राऊड बॉईज म्हणतात की ते मतदान केंद्रांवर असतील कारण ट्रम्प हिंसक वक्तृत्व आणि फसवणुकीच्या दाव्यांना चालना देत आहेत.	ट्रंपच्या हिंसक भाषणांचा व फ्रॉडच्या आरोपांचा वाढता प्रमाण प्राउड बॉयज पोलिंग ठिकाणी असण्याचा दावा करतात.
One of the police officers stumbled to the ground when the driver applied brakes and attempted to strike him.	ड्रायव्हरने ब्रेक लागू केल्यावर एका पोलिस अधिकारीला धक्का लागून जमिनीवर पडला.	जेव्हा चालकाने ब्रेक लावले आणि त्याला धडक देण्याचा प्रयत्न केला, तेव्हा पोलीस अधिकाऱ्यांपैकी एक जमिनीवर पडला.	एक पोलीस अधिकारी जमिनीवर कोसळला जेव्हा चालकाने ब्रेक लावले आणि त्याला मारण्याचा प्रयत्न केला.
The authorities confirmed they have identified the vehicle's owner and expect to make an arrest shortly.	प्राधिकरण म्हणाले की त्यांनी वाहनाच्या मालकाची ओळख केली आहे आणि लवकरात लवक ग्रहण करण्याची अपेक्षा आहे.	अधिकाऱ्यांनी पुष्टी केली आहे की त्यांनी वाहनाच्या मालकाची ओळख पटवली आहे आणि लवकरच अटक होईल अशी अपेक्षा आहे.	प्राधिकरणांनी त्यांनी वाहनाच्या मालकाची ओळख पटविली असून लवकरच अटक होण्याची अपेक्षा आहे.
The Chhatrapati Shivaji statue in the Arabian Sea off the Mumbai coast is referred to as a precedent for the proposed pen memorial.	मुंबईच्या तटावरील अरबी समुद्रातील छत्रपती शिवाजींची मूर्तीला 'प्रस्तावित कलम स्मारक'साठी एक उदाहरण म्हणून संदर्भित केले जाते.	मुंबई किनाऱ्याच्या अरबी समुद्रातील छत्रपती शिवाजी पुतळ्याचा संदर्भ प्रस्तावित पेन स्मारकासाठी एक उदाहरण म्हणून दिला जातो.	मुंबई किनारपट्टीवर अरबी समुद्रातील छत्रपती शिवाजी पुतळा प्रस्तावित पेन स्मारकासाठी एक उदाहरण म्हणून संदर्भित केला जातो.
Several political parties have opposed the pen memorial in the proposed location.	काही राजकीय पक्षांनी सुचवलेल्या स्थळावरच्या कलामालाच्या विरोधात आहेत.	प्रस्तावित ठिकाणी पेन स्मारकाला अनेक राजकीय पक्षांनी विरोध केला आहे.	अनेक राजकीय पक्षांनी प्रस्तावित स्थानावरील कलम स्मारकाला विरोध केला आहे.
They have not taken into consideration the rainfall data of 2015 or years thereafter. 	त्यांनी २०१५ वर्षाच्या वर्षाची माहिती किंवा उत्तरवर्षाची काळजी घेतली नाही.	त्यांनी २०१५ किंवा त्यानंतरच्या वर्षांचा पावसाचा डेटा विचारात घेतलेला नाही.	त्यांनी २०१५ किंवा त्यानंतरच्या वर्षांचा पावसाचा डेटा विचारात घेतला नाही.
The museum has been equipped with multimedia content, QR codes and holograms.	संग्रहालयाला मल्टिमिडिया सामग्री, क्यूआर कोड आणि होलोग्राम्स लागू केले गेले आहे.	संग्रहालयात मल्टिमीडिया सामग्री, QR कोड्स आणि होलोग्राम्ससह सुसज्ज केले गेले आहे.	संग्रहालयात मल्टिमीडिया सामग्री, क्यूआर कोड आणि होलोग्राम्सनी सुसज्जित केले आहे.
The ninth phase of the excavations would begin later this month, said officials.	अधिकाऱ्यांनी म्हणाले की उत्तमन्याची नव्या खडकाव्याची नवीन पाच आवृत्ती हा महिन्याच्या नंतर सुरु होईल.	अधिकाऱ्यांनी सांगितले की उत्खननाच्या नवव्या टप्प्याला या महिन्याच्या शेवटी सुरुवात होईल.	आज्ञाधिकाऱ्यांनी सांगितले की खननाची नववी टप्पा या महिन्याच्या उत्तरार्धात सुरू होईल.
Mr. Reddy is a close relative of Taraka Ratna's wife Alekya Reddy.	मि. रेड्डी तारक रत्नाच्या पत्नी अलेक्या रेड्डीचे निकट संबंधी आहेत.	श्री रेड्डी हे तारका रत्न यांच्या पत्नी आलेख्या रेड्डी यांचे जवळचे नातेवाईक आहेत.	टाराका रत्नाच्या पत्नी अलेक्या रेड्डी यांचा निकट संबंधी श्री रेड्डी आहे.
This betrays an inexplicable hostility towards knowledge creation of all kinds. 	हे सर्व प्रकारच्या ज्ञान सृजनावर अकारणात शत्रूता दर्शवते.	हे सर्व प्रकारच्या ज्ञान निर्मितीविषयी एका अव्याख्येय वैरभावाचे प्रदर्शन करते.	सर्व प्रकारच्या ज्ञान निर्मितीला अस्पष्टीवरोध दर्शवते.
The second is what he calls alienation from the process of labour.	दुसरं हे तो कामाच्या प्रक्रियेतून विच्छेदन त्यांचं म्हणजे काय.	दुसरे म्हणजे तो ज्याला श्रम प्रक्रियेपासून疱疱疱疱疱疱疱疱疱疱疱疱疱疱疱疱疱疱疱疱疱疱疱疱疱疱疱疱疱疱疱疱疱疱疱疱疱疱疱疱疱疱疱疱疱疱疱疱疱疱疱疱疱疱疱疱疱疱疱疱疱疱疱疱疱疱疱疱疱疱疱疱疱疱疱疱疱疱疱疱疱疱疱疱疱疱疱疱疱疱疱疱疱疱疱疱疱疱疱疱疱疱疱疱疱疱疱疱疱疱疱疱疱疱疱疱疱疱疱疱疱疱疱疱疱疱疱疱疱疱疱疱疱疱疱疱疱疱疱疱疱疱疱疱疱疱疱疱疱疱疱疱疱疱疱疱疱疱疱疱疱疱疱疱疱疱疱疱疱疱疱疱疱疱疱疱疱疱疱疱疱疱疱疱疱疱疱疱疱疱疱疱疱疱疱疱疱疱疱疱疱疱疱疱疱疱疱疱疱疱疱疱疱疱疱疱疱疱疱疱疱疱疱疱疱疱疱疱疱疱疱疱疱疱疱疱疱疱疱疱疱疱疱疱疱疱疱疱疱疱疱疱疱疱疱疱疱疱疱疱疱疱疱疱疱疱疱疱疱疱疱疱疱疱疱疱疱疱疱疱疱疱疱疱疱疱疱疱疱疱疱疱疱疱疱疱疱疱疱疱疱疱疱疱疱疱疱疱疱疱疱疱疱疱疱疱疱疱疱疱疱疱疱疱疱疱疱疱疱疱疱疱疱疱疱疱疱疱疱疱疱疱疱疱疱疱疱疱疱疱疱疱疱疱疱疱疱疱疱疱疱疱疱疱疱疱疱疱疱疱疱疱疱疱疱疱疱疱疱疱疱疱疱疱疱疱疱疱疱疱疱疱疱疱疱疱疱疱疱疱疱疱疱疱疱疱疱疱疱疱疱疱疱疱疱疱疱疱疱疱疱疱疱疱疱疱疱疱疱疱疱疱疱疱疱疱疱疱疱疱疱疱疱疱疱疱疱疱疱疱疱疱疱疱疱疱疱疱疱疱疱疱疱疱疱疱疱疱疱疱疱疱疱疱疱疱疱疱疱疱疱疱疱疱疱疱疱疱疱疱疱疱疱疱疱疱疱疱疱疱疱疱疱疱疱疱疱疱疱疱疱疱疱疱疱疱疱疱疱疱疱疱疱疱疱疱疱疱疱疱疱疱疱疱疱疱疱疱疱疱疱疱疱疱疱疱疱疱疱疱疱疱疱疱疱疱疱疱疱疱疱疱疱疱疱疱疱疱疱疱疱疱疱疱疱疱疱疱疱疱疱疱疱疱疱疱疱疱疱疱疱疱疱疱疱疱疱疱疱疱	कामाच्या प्रक्रियेपासून वेगळेपणा हे त्याचे म्हणणे आहे.
In the process, Marx argued, workers become miserable.	कामकाजाच्या प्रक्रियेत, मार्क्सने वाढवलं कि कामगार दु:खी होतात.	या प्रक्रियेत, मार्क्स म्हणाला, कामगार दु:खी होतात.	या प्रक्रियेत, मार्क्सने तर्क केला की, कामगार दुःखी होतात.
He asked the people to compare the scale of development in the adjoining Assam during eight years of BJP rule.	त्यांनी मानवांना म्हणावं की बीजेपीच्या आठ वर्षांच्या शासनातील समीप असणार्या आसाममधील विकासाचे मापदंड तुलना करून पहा.	त्यांनी लोकांना भाजपच्या आठ वर्षांच्या सत्ताकाळात शेजारील आसाममधील विकासाच्या स्तराची तुलना करण्यास सांगितले.	त्याने लोकांना भाजपच्या आठ वर्षांच्या कार्यकाळात आसाममधील विकासाच्या प्रमाणाची तुलना करण्यास सांगितले.
The DMK MP also said that the Budget presented by Union Finance Minister Nirmala Sitharaman had neglected sectors such as education, health and agriculture.	डीएमके सासंद नेते आणि संघीय वित्त मंत्री निर्मला सीतारमण यांनी पेश केलेला बजेट शिक्षण, आरोग्य आणि कृषि यांसारख्या क्षेत्रांच्या उपेक्षित केल्याचं म्हणालं.	डीएमके खासदारांनी देखील सांगितले की केंद्रीय अर्थमंत्री निर्मला सीतारामन यांनी सादर केलेल्या बजेटमध्ये शिक्षण, आरोग्य आणि शेती सारख्या क्षेत्रांकडे दुर्लक्ष करण्यात आले आहे.	डीएमके सांसदाने हे सुद्धा म्हटले की केंद्रीय अर्थमंत्री निर्मला सीतारामन यांनी सादर केलेल्या अर्थसंकल्पात शिक्षण, आरोग्य आणि शेती या क्षेत्रांना दुर्लक्षित केले आहे.
The accident took place around 3 p.m. on a State highway close to Korar village.	दुर्घटना सकाळी ३ वाजता कोरार गावासमोरील राज्यीय मार्गावर घडली.	अपघात दुपारी ३ वाजण्याच्या सुमारास कोरार गावाजवळील राज्य महामार्गावर झाला.	कोरार गावाच्या जवळच्या राज्य महामार्गावर साधारण ३ पी.एम. च्या सुमारास हा अपघात घडला.
Both the survivors are being treated at a hospital in Raipur.	दोन्ही बचेले रायपुरातील एक रुग्णालयात उपचारात आहेत.	दोन्ही बचावलेल्यांवर रायपूरमधील रुग्णालयात उपचार केले जात आहेत.	रायपूरच्या एका रुग्णालयात दोन्ही बचावलेले व्यक्ती उपचार घेत आहेत.
Chief Minister Bhupesh Baghel took to Twitter to express grief over the accident.	मुख्यमंत्री भूपेश बघेल दुर्घटनेविषयी दु:ख व्यक्त करण्यासाठी ट्विटरवर गेले.	मुख्यमंत्री भूपेश बघेल यांनी अपघाताबद्दल दु:ख व्यक्त करण्यासाठी ट्विटरचा वापर केला.	मुख्यमंत्री भूपेश बघेल यांनी अपघाताबद्दल दुःख व्यक्त करण्यासाठी ट्विटरवर प्रतिक्रिया दिली.
The Indian Institute of Technology Madras (IIT-M) Research Park hosted a competition for children.	भारतीय प्रौद्योगिकी संस्थान मद्रास (आयआयटी-एम) रिसर्च पार्कने मुलांसाठी एक प्रतिस्पर्धा आयोजित केली.	इंडियन इन्स्टिट्यूट ऑफ टेक्नॉलॉजी मद्रास (IIT-M) रिसर्च पार्कने मुलांसाठी एक स्पर्धेचे आयोजन केले.	भारतीय तंत्रज्ञान संस्था मद्रास (आयआयटी-एम) संशोधन उद्यानाने मुलांसाठी स्पर्धा आयोजित केली.
"External affairs minister S Jaishankar on Tuesday expressed concern over the attack on a Hindu temple in Canada, describing the incident as ""deeply concerning."	"बाह्य कार्य मंत्री एस जयशंकर आज शुक्रवारी इंडियातील हिंदू मंदिरावर हमला झाल्याच्या विषयी चिंता व्यक्त केली, घटनेचा वर्णन करून ""गंभीरतेने चिंताजनक"" म्हणाले."	"मंगळवारी परराष्ट्र व्यवहार मंत्री एस. जयशंकर यांनी कॅनडातील हिंदू मंदिरावर झालेल्या हल्ल्याबद्दल चिंता व्यक्त केली आणि या घटनेला ""खूप चिंताजनक"" असे वर्णन केले."	"कॅनडामधील हिंदू मंदिरावरील हल्ल्याबद्दल मंगलवारी परराष्ट्र मंत्री एस जयशंकर यांनी चिंता व्यक्त केली, ही घटना ""अत्यंत चिंताजनक"" असल्याचे त्यांनी सांगितले."
Modi condemns violence after Canada temple inciden.	मोदीने कॅनडा मंदिर घटनेनंतर हिंसेचे दोषारोपण केले.	कॅनडातील मंदिर घटनेनंतर मोदींनी हिंसाचाराचा निषेध केला.	मोदी कॅनडातील मंदिर प्रकरणानंतर हिंसाचाराला निषेध करतात.
Mr Nijjar had been a vocal supporter of the Khalistan movement and publicly campaigned for it.	श्री निज्जर खालिस्तान आंदोलनचा ध्वनीय समर्थक होते आणि त्यासाठी सार्वजनिकपणे प्रचार केले.	श्री निज्जर खलिस्तान चळवळीचे खुले समर्थक होते आणि त्यांनी त्यासाठी सार्वजनिक प्रचार केला होता.	श्री निज्जर Khalistan चळवळीचे स्पष्ट समर्थक होते आणि त्यासाठी सार्वजनिकपणे प्रचार करत होते.
Bangladesh steps up repayments to Adani to avoid power supply cu.	बांग्लादेशाने विद्युत आपूर्ती व्यवस्थापन टाकण्यासाठी आदानीला परतफेड करण्याचा प्रयत्न केला.	बांगलादेश वीज पुरवठा टाळण्यासाठी अदानीला परतफेड वाढवतो.	बांगलादेश अदानीला कर्ज फेडण्यास वाढवीत आहे जेणेकरून विज पुरवठा काटकटी टाळू शकेल.
The country is already suffering from increased power shortages in rural areas.	देशात आधुनिकीकरण क्षेत्रात विचारार्थांच्या क्षेत्रांमध्ये विद्युत कमी पडलेले आहे.	देश आधीच ग्रामीण भागांतील वाढत्या वीज टंचाईचा सामना करत आहे.	ग्रामीण भागात वीज पुरवठ्यात वाढती कमतरता देशाला आधीच भोगावी लागत आहे.
Officials said 44 people were on board when the driver lost control and the bus fell into a 50m-deep ditch in Marchula, located in the state’s Almora district.	अधिकाऱ्यांनी सांगितलं की चालकाला नियंत्रण गमवून अशी ४४ लोक जोरात बसमध्ये होती आणि मार्चुला, ज्यातील अल्मोरा जिल्ह्यात आहे, येथील ५० मीटरांच्या गहर्या खड्ड्यात बस काढुन पडली.	अधिकाऱ्यांनी सांगितले की, अल्मोरा जिल्ह्यातील मार्चुला येथे चालकाचा ताबा सुटल्याने बस 50 मीटर खोल खड्ड्यात कोसळली तेव्हा बसमध्ये 44 लोक होते.	अधिकार्‍यांनी सांगितले की मार्चुला येथे अल्मोडा जिल्ह्यात असलेल्या ५० मीटर खोल गटारात बस खाली पडली जेव्हा चालकाने नियंत्रण गमावले आणि तेव्हा बसमध्ये ४४ प्रवासी होते.
Uttarakhand's Chief Minister Pushkar Singh Dhami has also announced financial assistance for the victims and their families.	उत्तराखंडचे मुख्यमंत्री पुष्कर सिंग धामीने पीडितांच्या आणि त्यांच्या कुटुंबांसाठी आर्थिक सहाय्य घोषित केले आहे.	उत्तराखंडचे मुख्यमंत्री पुष्कर सिंह धामी यांनी देखील पीडित आणि त्यांच्या कुटुंबीयांना आर्थिक मदतीची घोषणा केली आहे.	उत्तराखंडचे मुख्यमंत्री पुष्कर सिंह धामी यांनीही पीडितांना व त्यांच्या कुटुंबियांना आर्थिक मदत जाहीर केली आहे.
Our scientists used it as an incentive to develop their own technology.	आमच्या वैज्ञानिकांनी त्याला स्वतःच्या तंत्रज्ञानाचा विकास करण्यासाठी प्रेरित केलं.	आमच्या शास्त्रज्ञांनी त्यांचा स्वतःचा तंत्रज्ञान विकसित करण्यासाठी प्रोत्साहन म्हणून याचा वापर केला.	आमचे वैज्ञानिक त्याला स्वतःची तंत्रज्ञान विकसित करण्यासाठी प्रेरणा म्हणून वापरले.
Mylswamy Annadurai, chief of India’s first and second Moon missions and Mars mission, told the BBC that Isro employs far fewer people and pays lower salaries, which makes Indian projects competitive.	माझ्या भारताच्या पहिल्या आणि दुसऱ्या चंद्रयान मिशन्स आणि मंगल मिशनचे मुख्य, मायल्स्वामी अन्नादुरै, बीबीसीला सांगितलं की इसरोला खूप कमी लोक कामी आणि कमी वेतन देतं, ज्यामुळे भारतीय प्रकल्प स्पर्धात्मक असतात.	भारताच्या पहिल्या आणि दुसऱ्या चंद्र मोहिमेचे आणि मंगळ मोहिमेचे प्रमुख मायस्वामी अन्नादुराई यांनी बीबीसीला सांगितले की इस्रो कमी लोकांना कामावर ठेवते आणि कमी पगार देते, ज्यामुळे भारतीय प्रकल्प स्पर्धात्मक ठरतात.	मायल्स्वामी अन्नादुरई, भारताच्या पहिल्या आणि दुसऱ्या चंद्रमission आणि मंगळ मिशनचे प्रमुख, बीबीसीला सांगितले की इस्रो कमी लोकांना रोजगार देते आणि कमी पगार देते, ज्यामुळे भारतीय प्रकल्प स्पर्धात्मक होतात.
Ex-district president of Bajrang Dal Gurgaon held for shooting at Gurgaon man.	बजरंग दल गुडगावच्या पूर्व जिल्हाध्यक्षाने गुडगावच्या एका व्यक्तीवर गोली मारण्याचा आरोपी झाला.	बजरंग दल गुरगांवचे माजी जिल्हाध्यक्ष गुरगांवमधील व्यक्तीवर गोळीबार केल्याच्या आरोपाखाली अटकेत.	बजरंग दलाचे माजी जिल्हा अध्यक्ष गुरगावच्या व्यक्तीवर गोळीबार करण्यासाठी अटक.
The legendary Bob Khathing led the expedition to peacefully integrate Tawang into India.	दुर्मिळ बॉब खाथिंग ने तावंग को भारत में शांतिपूर्वक एकीकृत करने के लिए अभियान का नेतृत्व किया।	पौराणिक बॉब खाथिंग यांनी तवांगला शांततेने भारतात समाकलित करण्यासाठी मोहिमेचे नेतृत्व केले.	किंवादंती बॉब खातिंग यांनी भारतात तवांगचे शांततापूर्ण एकीकरणासाठी मोहिम केली.
In 1939, after the Second World War broke out, Khathing joined the Indian Army and got an Emergency Commission as an officer.	१९३९ मध्ये, दुसर्या विश्व युद्धानंतर, खाथिंग भारतीय सेनेत सामील झाला आणि अधिकारी म्हणून एक आपत्कालीन कमिशन मिळालं.	1939 मध्ये, दुसरे महायुद्ध सुरू झाल्यानंतर, खाथिंग भारतीय सैन्यात सामील झाले आणि त्यांना अधिकारी म्हणून तातडीचा आयोग मिळाला.	१९३९ मध्ये, दुसरे महायुद्धाचा प्रारंभ झाल्यानंतर, खाथिंगने भारतीय सेनेत प्रवेश केला आणि ऑफिसर म्हणून एमर्जन्सी कमिशन मिळवले.
At the end of the Second World War, the Emergency Commissioned officers in the Army were demobilised.	दुसरे विश्व युद्धाच्या शेवटी, सेनेतील आपत्कालीन कमीशनदार अधिकाऱ्यांना नीचावले गेले.	द्वितीय महायुद्धाच्या समाप्तीनंतर, सैन्यातील आपत्कालीन नियुक्त अधिकाऱ्यांना सेवामुक्त करण्यात आले.	दुसऱ्या महायुद्धाच्या शेवटी, सेनेतील आणीबाणी अधिकारी निवृत्त झाले.
Most of the senior cricketers were far from their best, especially against New Zealand.	अधिकांश वरिष्ठ क्रिकेटर त्यांच्या सर्वोत्तमावरून अधिक आवारा होते, विशेषत: न्यूझीलंडविरुद्ध.	बहुतेक वरिष्ठ क्रिकेटपटू त्यांच्या सर्वोत्तम खेळापासून दूर होते, विशेषतः न्यूझीलंडविरुद्ध.	अधिकांश वरिष्ठ क्रिकेटपटू न्यू झीलंड विरुद्ध विशेषतः त्यांच्या सर्वोत्तम प्रदर्शनापासून दूर होते.
