src	gpt_3_5_trans	gpt_4o_trans	ollama_trans
JMM says Soren's helicopter take off delayed over PM's security protocol, writes to President Murmu	जेएमएम कहती है कि पीएम की सुरक्षा प्रोटोकॉल के कारण सोरेन के हेलीकॉप्टर का उड़ान लेना विलंबित हुआ, राष्ट्रपति मुर्मू को लिखती है।	जेएमएम का कहना है कि सोरेन के हेलीकॉप्टर का टेकऑफ पीएम की सुरक्षा प्रोटोकॉल के कारण विलंबित हुआ, राष्ट्रपति मुर्मू को पत्र लिखा।	जेएमएम का कहना है कि पीएम की सुरक्षा प्रोटोकॉल के कारण सोरेन के हेलीकॉप्टर के उड़ान में देरी हुई, राष्ट्रपति मुर्मू को पत्र लिखा
The king who defied the British: Uncovering the tale of Pazhassi raja’s rebellion	ब्रिटिश का सामना करने वाला राजा: पाझसी राजा की विद्रोह की कहानी का पता लगाना	ब्रिटिशों को चुनौती देने वाला राजा: पज़्हासी राजा के विद्रोह की कहानी का खुलासा।	ब्रिटिश के खिलाफ बगावत करने वाला राजा: पज़हस्सी राजा के विद्रोह की कहानी का अनावरण
Vinesh Phogat's retirement U-turn predicted after her latest Instagram post creates buzz on social media	विनेश फोगाट की सेवनिवृत्ति यातायात के बाद की पूर्वानुमानित कि जाती है, जब उनका नवीनतम इंस्टाग्राम पोस्ट सोशल मीडिया पर धूम मचाता है।	विनेश फोगाट के रिटायरमेंट के यू-टर्न की भविष्यवाणी उनके लेटेस्ट इंस्टाग्राम पोस्ट के बाद सोशल मीडिया पर चर्चा का विषय बन गई है।	विनेश फोगाट के संन्यास के यू-टर्न की भविष्यवाणी उनके नवीनतम इंस्टाग्राम पोस्ट से सोशल मीडिया पर सनसनी पैदा हुई है।
The Pennsylvania push: Kamala Harris, Donald Trump spend final campaign hours in swing state	पेन्सिल्वेनिया पुश: कमला हैरिस, डोनाल्ड ट्रंप अंतिम चुनावी घंटों को स्विंग राज्य में व्यतीत करते हैं।	पेंसिल्वेनिया की जोर: कमला हैरिस, डोनाल्ड ट्रंप ने स्विंग स्टेट में अंतिम प्रचार घंटे बिताए।	पेंसिल्वेनिया पुश: कमला हैरिस, डोनाल्ड ट्रंप स्विंग स्टेट में अंतिम चुनाव घंटे बिताते हैं
Delhi engulfed in smog, toxic foam in Yamuna: Pics that capture national capital's pollution woes	दिल्ली को स्मॉग में लपेटा, यमुना में विषैला फोम: छवियाँ जो राष्ट्रीय राजधानी की प्रदूषण समस्याओं को पकड़ती हैं।	दिल्ली धुंध में डूबी, यमुना में जहरीला झाग: राष्ट्रीय राजधानी की प्रदूषण समस्याओं को दर्शाने वाली तस्वीरें।	दिल्ली स्मॉग में घिरी, यमुना में जहरीला फोम: राष्ट्रीय राजधानी की प्रदूषण समस्याओं को कैप्चर करने वाली तस्वीरें
Will Muslim boycott of Kamala send Trump to the White House?	क्या कमला के मुस्लिम बॉयकॉट से ट्रंप को व्हाइट हाउस भेज देगा?	क्या मुस्लिमों का कमला का बहिष्कार ट्रम्प को व्हाइट हाउस भेजेगा?	क्या कामला के मुस्लिम бойकॉट ट्रंप को व्हाइट हाउस भेज देगा?
Why Indian batters are struggling against left-arm spin	भारतीय बैटर्स विपरीत हाथ के स्पिनर्स के खिलाफ संघर्ष क्यों कर रहे हैं?	भारतीय बल्लेबाज बाएं हाथ की स्पिन के खिलाफ संघर्ष क्यों कर रहे हैं?	क्यों भारतीय बल्लेबाज वाम-हाथ की स्पिन के खिलाफ संघर्ष कर रहे हैं
JD Vance calls Kamala Harris 'trash' at Atlanta rally: 'In 2 days we're taking out the garbage'	जेडी वैंस अटलांटा रैली में कमला हैरिस को 'कचरा' कहते हैं: '2 दिन में हम कचरा बाहर निकाल रहे हैं'।	जेडी वांस ने अटलांटा रैली में कमला हैरिस को 'कचरा' कहा: '2 दिन में हम कचरा बाहर निकाल रहे हैं'।	जेडी वेंस ने अटलांटा रैली में कमला हैरिस को 'कचरा' कहा: '2 दिन में हम कचरा निकाल रहे हैं'
Meghan and Harry feel life in US hasn't been what they expected: Ex-staff	मेघान और हैरी को ऐसा लगता है कि अमेरिका में जीवन वह नहीं था जैसा उन्होंने सोचा था: पूर्व कर्मचारी	मेघन और हैरी को लगता है कि अमेरिका में जीवन वैसा नहीं है जैसा उन्होंने उम्मीद की थी: पूर्व कर्मचारी।	मेगन और हैरी को लगता है कि अमेरिका में जीवन उनकी उम्मीद से अलग है: पूर्व-स्टाफ
Elon Musk reacts to reports that he could be deported for immigration violation	इलॉन मस्क की प्रतिक्रिया रिपोर्ट्स को लेकर जिसमें कहा गया है कि उन्हें प्रवासन उल्लंघन के लिए निर्धारित किया जा सकता है।	एलन मस्क ने उन रिपोर्टों पर प्रतिक्रिया दी कि उन्हें आव्रजन उल्लंघन के लिए निर्वासित किया जा सकता है।	एलन मस्क ने आव्रजन उल्लंघन के लिए निर्वासन की खबरों पर प्रतिक्रिया व्यक्त की।
How China is lessening its reliance on helium sourced from US	चीन अपनी एचिलियम की आवश्यकता को कैसे कम कर रहा है, जो संयुक्त राज्य से आता है।	कैसे चीन अमेरिका से प्राप्त हीलियम पर अपनी निर्भरता को कम कर रहा है।	चीन अमेरिका से स्रोत हीलियम पर अपनी निर्भरता कम कर रहा है।
Kindle Colorsoft owners complain of a yellow bar on the e-reader’s screen	किंडल कलरसॉफ्ट के मालिकों की शिकायत है कि इ-रीडर की स्क्रीन पर पीला बार है।	Kindle Colorsoft के मालिक ई-रीडर की स्क्रीन पर एक पीले बार की शिकायत कर रहे हैं।	किंडल कलरसॉफ्ट के मालिक ई-रीडर की स्क्रीन पर पीले रंग की पट्टी की शिकायत करते हैं।
Nvidia and its partners built a sophisticated system to bypass U.S. restrictions on exporting AI chips to the Middle East, Russia, and China.	न्विडिया और उसके साथी ने अमेरिका की प्रतिबंधों को मध्य पूर्व, रूस, और चीन को AI चिप्स निर्यात करने के लिए उनका एक परिष्कृत प्रणाली बनाई।	Nvidia और उसके साझेदारों ने मध्य पूर्व, रूस और चीन को AI चिप्स के निर्यात पर अमेरिकी प्रतिबंधों को दरकिनार करने के लिए एक उन्नत प्रणाली बनाई।	एनवीडिया और उसके साझेदारों ने अमेरिका द्वारा मध्य पूर्व, रूस और चीन को एआई चिप्स निर्यात पर प्रतिबंध को दरकिनार करने के लिए एक जटिल प्रणाली का निर्माण किया।
The funding, which will top up the firm’s flagship fund, will be raised primarily from institutional investors. 	वित्त प्रदान, जो कंपनी के प्रमुख निधि को ऊपर से भरने के लिए होगा, मुख्य रूप से संस्थागत निवेशकों से जुटाया जाएगा।	इस फंडिंग, जो कि फर्म के प्रमुख फंड को बढ़ाएगी, को मुख्य रूप से संस्थागत निवेशकों से जुटाया जाएगा।	संस्थागत निवेशकों से मुख्य रूप से जुटाया जाने वाला यह निधियन फ़र्म के प्रमुख कोष को और अधिक बढ़ाएगा।
US Forest Service Decision to Halt Prescribed Burns in California is History Repeating	यूएस फारेस्ट सर्विस का फैसला कैलिफोर्निया में प्रिस्क्राइब्ड बर्न्स को रोकने के लिए इतिहास दोहराने की बात है।	यूएस फॉरेस्ट सर्विस का कैलिफोर्निया में निर्धारित जलाने को रोकने का निर्णय इतिहास की पुनरावृत्ति है।	कैलिफ़ोर्निया में निर्धारित जलाने को रोकने का अमेरिकी वन सेवा निर्णय इतिहास की पुनरावृत्ति है
The man who gave us the solution to the Entscheidungsproblem	उस आदमी ने हमें एंट्स्चीडुंग्सप्रोब्लेम का समाधान दिया।	उस व्यक्ति ने हमें एंटशाइडुंग्सप्रॉब्लम का समाधान दिया।	वह आदमी जिसने हमें Entscheidungsproblem का समाधान दिया।
The shift in policy, covering government agencies and contractors working on national security, is intended to promote “responsible and ethical” innovations, the company said.	"नीति में परिवर्तन, जिसमें सरकारी एजेंसियों और राष्ट्रीय सुरक्षा पर काम करने वाले ठेकेदार शामिल हैं, ""जिम्मेदार और नैतिक"" नवाचारों को बढ़ावा देने का उद्देश्य है, कंपनी ने कहा।"	"कंपनी ने कहा कि राष्ट्रीय सुरक्षा पर काम कर रहे सरकारी एजेंसियों और ठेकेदारों को शामिल करने वाली नीति में परिवर्तन ""जिम्मेदार और नैतिक"" नवाचारों को बढ़ावा देने के लिए किया गया है।"	"राष्ट्रीय सुरक्षा पर काम करने वाली सरकारी एजेंसियों और ठेकेदारों को कवर करने वाली नीति में बदलाव, ""जिम्मेदार और नैतिक"" नवाचारों को बढ़ावा देने के लिए है, कंपनी ने कहा।"
China reveals a new heavy lift rocket that is a clone of SpaceX’s Starship	चीन ने एक नया हैवी लिफ्ट रॉकेट खुलासा किया है जो SpaceX के Starship की एक क्लोन है।	चीन ने एक नए भारी लिफ्ट रॉकेट का अनावरण किया है, जो SpaceX के स्टारशिप की नकल है।	चीन ने स्पेसएक्स के स्टारशिप की क्लोन वाला नया भारी लिफ्ट रॉकेट प्रदर्शित किया।
Singapore requires vehicle owners to bid for a set number of Certificates of Entitlement – costly operating permits valid for only ten years.	सिंगापुर को वाहन के मालिकों को अधिकार प्रमाणपत्र के लिए बोली लगानी पड़ती है - केवल दस साल के लिए मान्य संचालन अनुमतियाँ।	सिंगापुर में वाहन मालिकों को प्रमाणपत्रों की एक निर्धारित संख्या के लिए बोली लगानी होती है - महंगे संचालन परमिट जो केवल दस वर्षों के लिए मान्य होते हैं।	सिंगापुर वाहन मालिकों से प्रमाणपत्रों के एक निर्धारित संख्या के लिए नीलामी करने की आवश्यकता है, जो केवल दस वर्ष के लिए वैध महंगे संचालन परमिट हैं।
The Hwasong-19 is North Korea’s biggest missile yet and its test comes during a time of notable tensions on the peninsula.	ह्वासोंग-19 उत्तर कोरिया का अब तक सबसे बड़ा मिसाइल है और इसका परीक्षण उपनिवेश पर महत्वपूर्ण तनाव के समय में हो रहा है।	ह्वासोंग-19 उत्तर कोरिया की अब तक की सबसे बड़ी मिसाइल है और इसका परीक्षण प्रायद्वीप पर उल्लेखनीय तनाव के समय में हुआ है।	ह्वासोंग-19 उत्तर कोरिया की अब तक की सबसे बड़ी मिसाइल है और इसका परीक्षण पेनिन्सुला पर उल्लेखनीय तनाव के समय में हो रहा है.
The species may have been carried to the Sacramento–San Joaquin Delta in ballast water on ships	इस प्रजाति को शिप्स पर बैलेस्ट जल में सैक्रामेंटो-सैन जोआक्विन डेल्टा तक ले जाया गया हो सकता है।	यह प्रजाति जहाजों के बैलास्ट पानी के माध्यम से सैक्रामेंटो-सैन जोआक्विन डेल्टा तक लाई गई हो सकती है।	प्रजाति जहाज़ों पर बैलेस्ट वॉटर में सैक्रामेंटो-सैन जोक्विन डेल्टा में ले जाई गई हो सकती है।
Discovery partnered with PR firm Relevance International to produce ultra-luxury experiences and products under the banner of fictionaire billionaire Bruce Wayne’s conglomerate.	डिस्कवरी ने पीआर फर्म रिलीवेन्स इंटरनेशनल के साथ साझेदारी की ताकि उनके बैनर के तहत फिक्शनेयर बिल्यनेयर ब्रूस वेन के संघ के तहत अल्ट्रा-लक्जरी अनुभव और उत्पादों का निर्माण किया जा सके।	डिस्कवरी ने पीआर कंपनी रेलिवेंस इंटरनेशनल के साथ साझेदारी की है ताकि फ़िक्शनल अरबपति ब्रूस वेन के समूह के बैनर तले अल्ट्रा-लक्ज़री अनुभव और उत्पाद तैयार किए जा सकें।	डिस्कवरी ने फिक्शनेयर अरबपति ब्रूस वेन के कॉन्ग्लोमरेट के बैनर तले अल्ट्रा-लक्जरी अनुभवों और उत्पादों का निर्माण करने के लिए रिलेवेंस इंटरनेशनल नामक पीआर फर्म के साथ साझेदारी की।
Water utilities and chemical manufacturers are challenging the new EPA standards. 	जल सेवाएं और रासायनिक निर्माताएं नए ईपीए मानकों को चुनौती दे रही हैं।	जल उपयोगिताएं और रासायनिक निर्माता नए ईपीए मानकों को चुनौती दे रहे हैं।	जल उपयोगिताएं और रासायनिक निर्माता नए ईपीए मानकों को चुनौती दे रहे हैं।
A radio station in Poland fired its on-air talent and brought in A.I.-generated presenters. An outcry over a purported chat with a Nobel laureate quickly ended that experiment.	पोलैंड में एक रेडियो स्टेशन ने अपने ऑन-एयर प्रतिभाओं को निकाल दिया और ए.आई.-उत्पन्न प्रस्तुतकर्ताओं को लाया। एक नोबेल पुरस्कार विजेता के साथ किए गए एक दावे पर उत्तेजना जल्दी ही उस प्रयोग को समाप्त कर दिया।	पोलैंड के एक रेडियो स्टेशन ने अपने ऑन-एयर टैलेंट को निकाल दिया और उसकी जगह ए.आई. द्वारा निर्मित प्रस्तुतकर्ताओं को लाया। एक नोबेल पुरस्कार विजेता के साथ कथित बातचीत पर हुए विरोध के कारण वह प्रयोग जल्दी समाप्त हो गया।	पोलैंड में एक रेडियो स्टेशन ने अपने ऑन-एयर प्रतिभा को निकाल दिया और एआई-जनरेटेड प्रस्तुतकर्ताओं को लाया। एक नोबेल पुरस्कार विजेता के साथ कथित चैट पर हंगामा जल्द ही उस प्रयोग को समाप्त कर दिया।
From infancy, children show heightened interest in events that are impossible or improbable, relative to likely events.	बचपन से ही, बच्चों में वह उच्च रुचि दिखाई देती है जो घटनाएं असंभाव या असंभाव होती हैं, संभावनाओं के समान नहीं।	शैशवावस्था से ही, बच्चे उन घटनाओं में अधिक रुचि दिखाते हैं जो असंभव या असंभाव्य होती हैं, संभावित घटनाओं की तुलना में।	शैशव से, बच्चे असंभव या असंभाव्य घटनाओं में संभाव्य घटनाओं की तुलना में अधिक रुचि दिखाते हैं।
Four persons were referred to hospital and the rest were treated as outpatients at the event venue, police sources said.	चार व्यक्तियों को अस्पताल भेजा गया था और शेष व्यक्तियों को घटना स्थल पर आउटपेशेंट के रूप में इलाज किया गया, पुलिस स्रोतों ने बताया।	पुलिस सूत्रों ने बताया कि चार व्यक्तियों को अस्पताल भेजा गया और बाकी का इलाज कार्यक्रम स्थल पर बाह्य रोगियों के रूप में किया गया।	चार व्यक्तियों को अस्पताल में भेजा गया और शेष को आयोजन स्थल पर ओपीडी के रूप में इलाज किया गया, पुलिस सूत्रों ने कहा।
During investigation, the Washermenpet police found that he was attacked by three persons with stones and beer bottles while he was consuming alcohol.	जांच के दौरान, वाशरमेनपेट पुलिस ने पाया कि उसे तीन व्यक्तियों ने पत्थरों और बीयर बोतलों से हमला किया गया था जब वह शराब पी रहा था।	जांच के दौरान, वॉशरमेनपेट पुलिस को पता चला कि उस पर तीन व्यक्तियों ने पत्थरों और बीयर की बोतलों से हमला किया था जब वह शराब पी रहा था।	जांच के दौरान, वाशरमेनपेट पुलिस ने पाया कि वह तीन व्यक्तियों द्वारा पत्थरों और बीयर की बोतलों से हमला किया गया था जब वह शराब का सेवन कर रहा था।
Two juvenile boys who were lodged at the Government Observation Home in Chengalpattu escaped on Tuesday night.	दो किशोर लड़के जो चेंगलपट्टू में सरकारी अवलोकन गृह में निवास कर रहे थे, उन्होंने मंगलवार रात को भाग लिया।	चेन्गलपट्टू के सरकारी पर्यवेक्षण गृह में रखे गए दो किशोर लड़के मंगलवार रात को भाग गए।	चेंगलपट्टु में सरकारी अवलोकन होम में रखे गए दो नाबालिग लड़के मंगलवार रात भाग निकले।
During Mr. Gandhi’s Srinagar stay, men disembarked from cars on Boulevard road to hug him.	मिस्टर गांधी के स्रीनगर में ठहरने के दौरान, बुलेवर्ड रोड पर से लोग उतरकर उनसे गले मिलने आए।	श्री गांधी की श्रीनगर यात्रा के दौरान, बुलेवार्ड रोड पर लोग कारों से उतरकर उन्हें गले लगाने के लिए आए।	श्री गांधी के श्रीनगर प्रवास के दौरान, बुलेवार्ड रोड पर कारों से उतरे पुरुषों ने उन्हें गले लगाया।
They alleged that several brick kilns started selling old stocks of bricks from Wednesday after paying the first instalment of the fine levied on them by the Geology and Mining Department.	उन्होंने आरोप लगाया कि कई ईंट किलों ने उन पर लगाए गए जीओलॉजी और माइनिंग विभाग द्वारा उन पर लगाये गए जुर्माने की पहली किस्त का भुगतान करने के बाद बुधवार से पुराने स्टॉक की ईंटें बेचना शुरू कर दिया।	उन्होंने आरोप लगाया कि भूविज्ञान और खनन विभाग द्वारा लगाए गए जुर्माने की पहली किस्त का भुगतान करने के बाद कई ईंट भट्टों ने बुधवार से पुरानी ईंटों का स्टॉक बेचना शुरू कर दिया।	वे आरोप लगाते हैं कि बुधवार से कई ईंट भट्टे ने जियोलॉजी और माइनिंग विभाग द्वारा उन पर लगाये गए जुर्माने की पहली किस्त चुकाने के बाद पुराने ईंट स्टॉक की बिक्री शुरू कर दी।
Ten Indian career diplomats, who are High Commissioners or Ambassadors of India in other countries, called on Governor R.N. Ravi at the Raj Bhavan in Chennai on Monday.	दस भारतीय करियर डिप्लोमेट्स, जो अन्य देशों में भारत के उच्चायुक्त या राजदूत हैं, सोमवार को चेन्नई में राज भवन में गवर्नर आर.एन. रवि से मिलने गए।	सोमवार को दस भारतीय कैरियर राजनयिक, जो अन्य देशों में भारत के उच्चायुक्त या राजदूत हैं, ने चेन्नई के राजभवन में राज्यपाल आर.एन. रवि से मुलाकात की।	दस भारतीय करियर राजनयिक, जो अन्य देशों में भारत के उच्चायुक्त या राजदूत हैं, ने सोमवार को चेन्नई में राज भवन में राज्यपाल आर.एन. रवि से मुलाकात की।
However, Dr. Hande, who wrote the foreword for her book and took part in some of these Assembly debates, says Muthu discharged her duty efficiently as a Minister with no room for corruption.	फिर भी, डॉ. हंडे, जिन्होंने उसकी पुस्तक के लिए प्रारंभिक भाषण लिखा और इन सभी विधानसभा बहसों में भाग लिया, कहते हैं कि मुथु ने भ्रष्टाचार के लिए कोई जगह न देते हुए मंत्री के रूप में अपना कार्य कुशलता से निष्पादित किया।	हालांकि, डॉ. हांडे, जिन्होंने उनकी पुस्तक के लिए प्रस्तावना लिखी और कुछ विधानसभा बहसों में भाग लिया, कहते हैं कि मुथु ने एक मंत्री के रूप में अपनी जिम्मेदारी कुशलता से निभाई और भ्रष्टाचार की कोई गुंजाइश नहीं छोड़ी।	हालांकि, डॉ. हंडे ने जिनकी पुस्तक के लिए फॉरवर्ड लिखा और इन विधानसभा बहसों में भाग लिया, वे कहते हैं कि मुथु ने एक मंत्री के रूप में अपना कर्तव्य कुशलता से निभाया जिसके लिए भ्रष्टाचार की कोई गुंजाइश नहीं थी।
While both Mr. Lobo and Mr. Kamat have cited disaffection with the Congress high command as reasons, the true reasons are all too transparent.	जबकि दोनों श्री लोबो और श्री कामत ने कांग्रेस के उच्च कमान के साथ असंतुष्टि का स्तर देने के कारण दिया है, सच्चे कारण सभी के लिए पर्दाफाश है।	हालांकि श्री लोबो और श्री कामत दोनों ने कांग्रेस हाई कमान से असंतोष को कारण बताया है, असली कारण पूरी तरह से स्पष्ट हैं।	जबकि श्री लोबो और श्री कामत दोनों ने कांग्रेस उच्च कमान से असंतोष को कारण बताया है, सच्चे कारण साफ़-साफ़ दिखाई दे रहे हैं।
The first festival celebrating the linguistic and cultural ties between the Barak Valley region of Assam and the Sylhet segment of Bangladesh began on Friday evening.	असम के बाराक घाटी क्षेत्र और बांग्लादेश के सिलहेट सेगमेंट के बीच भाषाई और सांस्कृतिक संबंधों का पहला उत्सव शुक्रवार शाम को शुरू हुआ।	असम के बराक घाटी क्षेत्र और बांग्लादेश के सिलहट खंड के बीच भाषाई और सांस्कृतिक संबंधों का जश्न मनाने वाला पहला त्योहार शुक्रवार शाम को शुरू हुआ।	असम के बराक वैली क्षेत्र और बांग्लादेश के सिलहट सेगमेंट के बीच भाषाई और सांस्कृतिक संबंधों का पहला त्योहार शुक्रवार शाम से शुरू हुआ।
The objective of such markets is to incentivise investments in renewable energy sources.	इस प्रकार के बाजारों का उद्देश्य नवीकरणीय ऊर्जा स्रोतों में निवेश को प्रोत्साहित करना है।	ऐसे बाजारों का उद्देश्य नवीकरणीय ऊर्जा स्रोतों में निवेश को प्रोत्साहित करना है।	ऐसे बाजारों का उद्देश्य नवीकरणीय ऊर्जा स्रोतों में निवेश को प्रोत्साहित करना है।
The Centre is expected to clarify, later this year, the specifics of a carbon trading market in India.	केंद्र की उम्मीद है कि इस साल के बाद में भारत में कार्बन ट्रेडिंग मार्केट की विशेषताएँ स्पष्ट करेगा।	केंद्र से इस वर्ष के अंत में भारत में कार्बन ट्रेडिंग बाजार की विशेषताओं को स्पष्ट करने की उम्मीद है।	इस साल बाद में, भारत में कार्बन ट्रेडिंग मार्केट के विशिष्ट विवरण को स्पष्ट करने की उम्मीद है केंद्र से।
Hydrogen is an essential industrial fuel that has a range of uses from producing ammonia.	हाइड्रोजन एक आवश्यक औद्योगिक ईंधन है जिसका उपयोग अमोनिया उत्पादन से शुरू होकर कई उपयोगों के लिए होता है।	हाइड्रोजन एक आवश्यक औद्योगिक ईंधन है जिसका अमोनिया के उत्पादन सहित अनेक उपयोग हैं।	हाइड्रोजन एक आवश्यक औद्योगिक ईंधन है जिसका उपयोग अमोनिया उत्पादन से लेकर कई क्षेत्रों में होता है।
Finance Minister Nirmala Sitharaman on Saturday said that regulators would do their job.	वित्त मंत्री निर्मला सीतारमण ने शनिवार को कहा कि पररवाहीकर्ता अपना काम करेंगे।	वित्त मंत्री निर्मला सीतारमण ने शनिवार को कहा कि नियामक अपना काम करेंगे।	वित्त मंत्री निर्मला सीतारमण ने शनिवार को कहा कि नियामक अपना काम करेंगे।
Madras has received a grant of ₹242 crore to do research on laboratory-grown diamonds.	मद्रास को 242 करोड़ रुपये का अनुदान मिला है जिसका उपयोग प्रयोगशाला में उत्पन्न हुए हीरे पर शोध करने के लिए किया जाएगा।	मद्रास को प्रयोगशाला में उगाए गए हीरों पर शोध करने के लिए ₹242 करोड़ का अनुदान प्राप्त हुआ है।	मद्रास को लैबोरेटरी-विकसित हीरों पर शोध करने के लिए 242 करोड़ रुपये का अनुदान प्राप्त हुआ है।
Before Rao took leave after the meeting, MGR gently reminded him of the Cauvery water.	राव ने मीटिंग के बाद छुट्टी लेने से पहले, एमजीआर ने उसे कावेरी जल की सावधानी से याद दिलाई।	बैठक के बाद राव के विदा लेने से पहले, एमजीआर ने उन्हें कावेरी नदी के पानी की सौम्यता से याद दिलाई।	मीटिंग के बाद राव ने छुट्टी लेने से पहले, एमजीआर ने उन्हें कावेरी जल की याद दिला दी।
It is because of this initiative that Tamil Nadu became the centre of higher learning.	इस पहल के कारण ही तमिलनाडु उच्च शिक्षा केंद्र बन गया।	इसी पहल के कारण तमिलनाडु उच्च शिक्षा का केंद्र बन गया।	इस पहल के कारण तमिलनाडु उच्च शिक्षा का केंद्र बन गया।
However, within minutes after the then Prime Minister intervened.	तथापि, उस समय के प्रधानमंत्री ने हस्तक्षेप किया।	हालांकि, तत्कालीन प्रधानमंत्री के हस्तक्षेप के कुछ ही मिनटों बाद।	परंतु फिर प्रधानमंत्री के हस्तक्षेप के कुछ मिनट बाद।
The initial shock following the Taliban’s seizure of power in Kabul is waning.	काबुल में तालिबान की शक्ति हासिल करने के बाद पहला झटका कम हो रहा है।	काबुल में तालिबान के सत्ता पर कब्जे के बाद की प्रारंभिक सदमा कम हो रही है।	काबुल में तालिबान के सत्ता पर कब्जे के बाद का आरंभिक सदमा कम हो रहा है.
The greatest impact of denial of rights for women in the workforce would be a sharp contraction in the economy.	महिलाओं के अधिकारों की इनकार की सबसे बड़ी प्रभाव स्थल पर महिलाओं के लिए अधिकारों का इनकार करने का सबसे बड़ा प्रभाव होगा।	महिलाओं के कार्यस्थल में अधिकारों के अभाव का सबसे बड़ा प्रभाव अर्थव्यवस्था में तीव्र संकुचन होगा।	महिलाओं के कार्यबल में अधिकारों से इनकार का सबसे बड़ा प्रभाव अर्थव्यवस्था में तीव्र संकुचन होगा।
The Taliban do not shy from leveraging the issue to gain international attention.	टालिबान अंतरराष्ट्रीय ध्यान प्राप्त करने के लिए मुद्दे का उपयोग करने से नहीं हिचकिचाते।	तालिबान इस मुद्दे का उपयोग अंतरराष्ट्रीय ध्यान आकर्षित करने के लिए करने से नहीं हिचकिचाता।	तालिबान अंतरराष्ट्रीय ध्यान आकर्षित करने के लिए इस मुद्दे का लाभ उठाने से नहीं हिचकिचाते।
In Jammu and Kashmir, the enrolment dropped sharply from 1.78 lakh in 2019-20 to 1.31 lakh in 2020-21.	जम्मू और कश्मीर में, 2019-20 में 1.78 लाख से 2020-21 में 1.31 लाख तक छात्र नामांकन में तेजी से कमी हुई।	जम्मू और कश्मीर में, नामांकन 2019-20 में 1.78 लाख से घटकर 2020-21 में 1.31 लाख रह गया।	जम्मू और कश्मीर में, 2019-20 में 1.78 लाख से 2020-21 में 1.31 लाख तक नामांकन में तेजी से गिरावट आई।
Senior advocate Meenakshi Arora made the oral mentioning for early hearing.	वरिष्ठ वकील मीनाक्षी अरोड़ा ने जल्दी सुनवाई के लिए मौखिक उल्लेख किया।	वरिष्ठ अधिवक्ता मीनाक्षी अरोड़ा ने जल्द सुनवाई के लिए मौखिक उल्लेख किया।	वरिष्ठ अधिवक्ता मीनाक्षी अरोरा ने शीघ्र सुनवाई के लिए मौखिक उल्लेख किया।
The State had never forced students out of State schools by restricting hijab.	राज्य ने किसी भी छात्र को हिजाब की प्रतिबंधिता के द्वारा राज्य स्कूल से बाहर निकाला नहीं था।	राज्य ने हिजाब पर प्रतिबंध लगाकर छात्रों को राज्य के स्कूलों से कभी बाहर नहीं निकाला था।	राज्य ने कभी हिजाब को प्रतिबंधित करके राज्य के स्कूलों से छात्रों को बाहर नहीं निकाला।
The patient has the right to refuse to participate in such research projects.	रोगी का हक है कि वह ऐसे शोध परियोजनाओं में भाग लेने से इनकार कर सके।	मरीज़ को ऐसे शोध परियोजनाओं में भाग लेने से इंकार करने का अधिकार है।	रोगी ऐसे शोध परियोजनाओं में भाग लेने से इनकार करने का अधिकार रखता है।
The field officials should remember it while implementing projects. 	कार्यक्रम को लागू करते समय क्षेत्रीय अधिकारियों को इसे ध्यान में रखना चाहिए।	क्षेत्रीय अधिकारियों को परियोजनाओं को लागू करते समय इसे याद रखना चाहिए।	क्षेत्र अधिकारियों को परियोजनाओं को लागू करते समय यह याद रखना चाहिए।
Senior officials in the Ministry of Tribal Affairs said a change in the structure had already been approved.	जनजातीय कार्य मंत्रालय के वरिष्ठ अधिकारी ने कहा कि संरचना में परिवर्तन को पहले से ही मंजूरी दे दी गई थी।	जनजातीय मामलों के मंत्रालय के वरिष्ठ अधिकारियों ने कहा कि संरचना में बदलाव पहले ही मंजूर किया जा चुका है।	आदिवासी मामलों के मंत्रालय में वरिष्ठ अधिकारियों ने कहा कि संरचना में परिवर्तन पहले ही स्वीकृत हो चुका है.
The Bhagwan Mahaveer Foundation has called for applications for the Mahaveer awards.	भगवान महावीर फाउंडेशन ने महावीर पुरस्कार के लिए आवेदन आमंत्रित किए हैं।	भगवान महावीर फाउंडेशन ने महावीर पुरस्कारों के लिए आवेदनों का आह्वान किया है।	भगवान महावीर फाउंडेशन ने महावीर पुरस्कार के लिए आवेदन आमंत्रित किए हैं।
Mr. Yediyurappa resigned as Chief Minister and was succeeded by Basavaraj Bommai in 2020.	श्री येदियुरप्पा ने 2020 में मुख्यमंत्री के पद से इस्तीफा दिया और उनके स्थान पर बासवराज बोम्मई ने उत्तराधिकार किया।	श्री येदियुरप्पा ने मुख्यमंत्री पद से इस्तीफा दे दिया और 2020 में उनकी जगह बसवराज बोम्मई ने ली।	श्री येदियुरप्पा ने 2020 में मुख्यमंत्री पद से इस्तीफा दे दिया और उनके स्थान पर बसवराज बोम्मई ने पद संभाला।
The rescuers had to cut the roof of the lift to bring them out, and nobody was hurt.	बचावकर्ताओं को उन्हें बाहर लाने के लिए लिफ्ट की छत काटनी पड़ी और किसी को चोट नहीं आई।	बचावकर्मियों को उन्हें बाहर निकालने के लिए लिफ्ट की छत काटनी पड़ी, और कोई भी घायल नहीं हुआ।	बचाव दल को लिफ्ट की छत काटनी पड़ी ताकि उन्हें बाहर निकाला जा सके, और किसी को चोट नहीं आई।
The group claimed another police station attack in Rask that killed one officer on January 10.	समूह ने 10 जनवरी को रास्क में एक पुलिस थाने पर हमला करने का दावा किया जिसमें एक ऑफिसर की मौत हो गई।	समूह ने 10 जनवरी को रास्क में एक और पुलिस स्टेशन हमले की ज़िम्मेदारी ली, जिसमें एक अधिकारी की मौत हो गई।	रास्क में 10 जनवरी को एक पुलिस अधिकारी की मौत हुई, जिसमें समूह ने दावा किया कि पुलिस स्टेशन पर हमला किया था।
Based on the complaint, an FIR has been registered against Constable Shailendra Singh and three other policemen.	शिकायत के आधार पर, कॉन्स्टेबल शैलेंद्र सिंह और तीन अन्य पुलिस अधिकारियों के खिलाफ एफआईआर दर्ज की गई है।	शिकायत के आधार पर कांस्टेबल शैलेंद्र सिंह और तीन अन्य पुलिसकर्मियों के खिलाफ एक एफआईआर दर्ज की गई है।	शिकायत के आधार पर, कॉन्स्टेबल शैलेंद्र सिंह और तीन अन्य पुलिसकर्मियों के खिलाफ एफआईआर दर्ज की गई है।
Financial institutions also play a crucial role in tracking the money trails sustaining these networks.	वित्तीय संस्थान भी इन नेटवर्कों को स्थायी रूप से संभालने वाले पैसे के नियमों का पता लगाने में महत्वपूर्ण भूमिका निभाते हैं।	वित्तीय संस्थाएँ इन नेटवर्क को बनाए रखने वाले धन के प्रवाह का पता लगाने में भी महत्वपूर्ण भूमिका निभाती हैं।	वित्तीय संस्थान भी इन नेटवर्क्स का समर्थन करने वाले धन के निशान का पता लगाने में एक महत्वपूर्ण भूमिका निभाते हैं।
It is laudable that customs duties have been waived on three anti-cancer drugs.	तारीफ़नीय है कि तीन एंटी-कैंसर दवाओं पर सामान्य करों की छूट दे दी गई है।	यह सराहनीय है कि तीन एंटी-कैंसर दवाओं पर सीमा शुल्क माफ कर दिया गया है।	तीन एंटी-कैंसर दवाओं पर सीमा शुल्क माफ किए जाने की प्रशंसा की जानी चाहिए।
Inside the final sprint in the biggest battleground state on the map.	नक्शे पर सबसे बड़े युद्धभूमि राज्य में अंतिम स्प्रिंट के भीतर।	नक्शे पर सबसे बड़े युद्धभूमि राज्य में अंतिम दौड़ के अंदर।	नक्शे पर सबसे बड़े युद्धक्षेत्र राज्य में अंतिम स्प्रिंट के अंदर।
All eyes are on America as an uncertain world awaits election result.	सभी नजरें अमेरिका पर हैं जैसे कि एक अनिश्चित दुनिया चुनाव परिणाम की प्रतीक्षा में है।	एक अनिश्चित दुनिया चुनाव परिणाम की प्रतीक्षा कर रही है और सभी की निगाहें अमेरिका पर टिकी हैं।	अमेरिका के चुनाव परिणाम की प्रतीक्षा में अनिश्चित दुनिया की सभी आंखें अमेरिका पर टिकी हुई हैं।
Twitch faces criticism over Israel-Gaza war content on platform.	ट्विच प्लेटफ़ॉर्म पर इज़राइल-गाज़ा युद्ध सामग्री के ऊपर आलोचना का सामना कर रहा है।	ट्विच को प्लेटफॉर्म पर इज़राइल-गाज़ा युद्ध संबंधी सामग्री के कारण आलोचना का सामना करना पड़ रहा है।	ट्विच प्लेटफॉर्म पर इस्राइल-गाजा युद्ध सामग्री को लेकर आलोचना का सामना कर रहा है.
North Korea fires multiple ballistic missiles toward the sea ahead of U.S. election.	उत्तर कोरिया ने संयुक्त राज्य चुनाव के पहले समुद्र की ओर कई बैलिस्टिक मिसाइल चलाए।	उत्तरी कोरिया ने अमेरिका के चुनाव से पहले समुद्र की ओर कई बैलिस्टिक मिसाइलें दागीं।	उत्तर कोरिया ने अमेरिकी चुनाव से पहले समुद्र की ओर कई बैलिस्टिक मिसाइलें दागीं।
Singapore Airlines will add first class, revamp cabins for longest flights.	सिंगापुर एयरलाइंस सबसे लंबी उड़ानों के लिए पहली क्लास जोड़ेगी, केबिन को नया रूप देगी।	सिंगापुर एयरलाइंस अपनी सबसे लंबी उड़ानों के लिए प्रथम श्रेणी जोड़ेगी और केबिनों को नया रूप देगी।	सिंगापुर एयरलाइन्स अपनी सबसे लंबी उड़ानों के लिए फर्स्ट क्लास जोड़ेगी और केबिनों का नवीनीकरण करेगी।
Priyanka Chopra Jonas and Nick Jonas celebrate 'Diwaloween,' Diwali and Halloween mashup.	प्रियंका चोपड़ा जोनस और निक जोनस 'डिवालोवीन' मनाते हैं, दिवाली और हैलोवीन का मैशअप।	प्रियंका चोपड़ा जोनास और निक जोनास ने 'दिवालोवीन,' दिवाली और हैलोवीन के मिश्रण का जश्न मनाया।	प्रियंका चोपड़ा जोनस और निक जोनस 'डिवालोवीन' मनाते हैं, दिवाली और हैलोवीन का मिश्रण।
Pennsylvania officials denounce Halloween float appearing to depict Harris tied to golf cart.	पेन्सिल्वेनिया के अधिकारी हैलोवीन फ्लोट की कठिनाइयों की नकल करने की निंदा करते हैं, जो हैरिस को गोल्फ कार्ट से जोड़ने की तरह दिखाई देता है।	पेंसिल्वेनिया के अधिकारियों ने हैलोवीन फ्लोट की निंदा की, जो हैरिस को गोल्फ कार्ट से बंधा हुआ दिखाते हुए प्रतीत होता है।	पेंसिलवेनिया के अधिकारियों ने हैलोवीन फ्लोट की निंदा की जिसमें हैरिस को गोल्फ कार्ट से बंधा हुआ दिखाया गया था।
Elon Musk's election-doubting posts shared 9 times more than his less extreme election content.	इलॉन मस्क के चुनाव से संबंधित संदेशों को उसके कम उत्कृष्ट चुनाव सामग्री की तुलना में 9 गुना ज्यादा शेयर किया गया।	एलन मस्क की चुनाव पर सवाल उठाने वाली पोस्टें उनकी कम चरम चुनावी सामग्री की तुलना में 9 गुना अधिक साझा की गईं।	एलोन मस्क के चुनाव-संदेह वाले पोस्ट उनके कम चरम चुनाव सामग्री से 9 गुना अधिक साझा किए गए।
Americans eye the economy from kitchen tables and hourly jobs as they plan their votes.	अमेरिकी लोग अपने मतदान की योजना बनाते समय अपने रसोई मेजों और प्रति-घंटे के नौकरियों से अर्थव्यवस्था पर ध्यान देते हैं।	अमेरिकी अपनी रसोई की मेजों और प्रति घंटा नौकरियों से अर्थव्यवस्था को देखते हैं जब वे अपने वोट की योजना बनाते हैं।	अमेरिकी रसोई की मेज और प्रति घंटा नौकरियों से अर्थव्यवस्था को देखते हुए अपने वोट की योजना बना रहे हैं।
Quincy Jones, musical maestro and entertainment industry titan, dies at 91.	क्विंसी जोन्स, संगीत के माहिर और मनोरंजन उद्योग का शासक, 91 साल की उम्र में मर गए।	क्विंसी जोन्स, संगीत के माएस्ट्रो और मनोरंजन उद्योग के दिग्गज, का 91 वर्ष की आयु में निधन हो गया।	क्विंसी जोन्स, संगीत के महानायक और मनोरंजन उद्योग के दिग्गज, 91 पर निधन हो गया.
Proud Boys claim they'll be at polling places as Trump ups violent rhetoric and fraud claims	गर्वित लड़के दावा करते हैं कि ट्रंप हिंसक भाषण और धोखाधड़ी के दावे बढ़ाते हैं तो वो मतदान स्थानों पर होंगे।	प्राउड बॉयज का दावा है कि वे मतदान स्थलों पर मौजूद रहेंगे, जबकि ट्रंप ने हिंसक बयानबाजी और धोखाधड़ी के दावों को बढ़ा दिया है।	प्राउड बॉयज़ दावा करते हैं कि वे मतदान स्थलों पर होंगे क्योंकि ट्रंप हिंसक भाषण और धोखाधड़ी के दावे बढ़ाते हैं।
One of the police officers stumbled to the ground when the driver applied brakes and attempted to strike him.	ड्राइवर ने ब्रेक लगाया जब एक पुलिस अधिकारी ज़मीन पर गिर गया और उसे मारने की कोशिश की।	जब ड्राइवर ने ब्रेक लगाए और उसे मारने की कोशिश की, तो पुलिस अधिकारियों में से एक जमीन पर गिर पड़ा।	पुलिस अधिकारियों में से एक जमीन पर गिर पड़ा जब ड्राइवर ने ब्रेक लगाया और उसे मारने की कोशिश की।
The authorities confirmed they have identified the vehicle's owner and expect to make an arrest shortly.	प्राधिकरणों ने पुष्टि की कि उन्होंने वाहन के मालिक की पहचान की है और जल्द ही गिरफ्तारी करने की उम्मीद है।	अधिकारियों ने पुष्टि की कि उन्होंने वाहन के मालिक की पहचान कर ली है और जल्द ही गिरफ्तारी की उम्मीद है।	प्राधिकारियों ने पुष्टि की है कि वे वाहन के मालिक की पहचान कर चुके हैं और शीघ्र ही गिरफ्तारी की उम्मीद है.
The Chhatrapati Shivaji statue in the Arabian Sea off the Mumbai coast is referred to as a precedent for the proposed pen memorial.	मुंबई के तट पर अरब सागर में स्थित छत्रपति शिवाजी की मूर्ति को प्रस्तावित कलम स्मारक के लिए एक पूर्वाग्रह के रूप में संदर्भित किया जाता है।	मुंबई तट के पास अरब सागर में स्थित छत्रपति शिवाजी की प्रतिमा को प्रस्तावित पेन स्मारक के लिए एक मिसाल के रूप में देखा जाता है।	मुंबई तट से अरब सागर में स्थित छत्रपति शिवाजी की प्रतिमा प्रस्तावित पेन स्मारक के लिए एक पूर्वाधिकार के रूप में उल्लेख की जाती है।
Several political parties have opposed the pen memorial in the proposed location.	कई राजनीतिक पार्टियों ने प्रस्तावित स्थान पर पेन स्मारक का विरोध किया है।	कई राजनीतिक दलों ने प्रस्तावित स्थान पर पेन स्मारक का विरोध किया है।	कई राजनीतिक दलों ने प्रस्तावित स्थान पर कलम स्मारक का विरोध किया है.
They have not taken into consideration the rainfall data of 2015 or years thereafter. 	उन्होंने 2015 के मौसम की जानकारी या उसके बाद के सालों को ध्यान में नहीं रखा है।	उन्होंने 2015 की वर्षा के आंकड़ों या उसके बाद के वर्षों को ध्यान में नहीं लिया है।	वे 2015 या उसके बाद के वर्षों के वर्षा डेटा को विचार में नहीं लिया है।
The museum has been equipped with multimedia content, QR codes and holograms.	संग्रहालय को मल्टीमीडिया सामग्री, क्यूआर कोड्स और होलोग्राम के साथ सुसज्जित किया गया है।	संग्रहालय को मल्टीमीडिया सामग्री, क्यूआर कोड और होलोग्राम से सुसज्जित किया गया है।	संग्रहालय को मल्टीमीडिया सामग्री, क्यूआर कोड और होलोग्राम से सुसज्जित किया गया है।
The ninth phase of the excavations would begin later this month, said officials.	अधिकारी ने कहा कि खुदाई की नौवीं चरण इस महीने के बाद शुरू होगी।	अधिकारियों ने कहा कि खुदाई का नौवां चरण इस महीने के अंत में शुरू होगा।	इस महीने के बाद आधिकारियों ने कहा कि खुदाई का नौवां चरण शुरू होगा।
Mr. Reddy is a close relative of Taraka Ratna's wife Alekya Reddy.	मिस्टर रेड्डी तारका रत्ना की पत्नी अलेख्या रेड्डी के नजदीकी रिश्तेदार हैं।	श्री रेड्डी, तारक रत्न की पत्नी आलेक्या रेड्डी के करीबी रिश्तेदार हैं।	श्री रेड्डी टाराका रत्ना की पत्नी अलेक्या रेड्डी के एक करीबी रिश्तेदार हैं।
This betrays an inexplicable hostility towards knowledge creation of all kinds. 	यह सभी प्रकार के ज्ञान सृजन के प्रति एक अकथनीय दुश्मनी का प्रकटीकरण करता है।	यह सभी प्रकार के ज्ञान सृजन के प्रति एक अव्याख्येय शत्रुता को प्रकट करता है।	यह सभी प्रकार के ज्ञान सृजन के प्रति अकल्पनीय शत्रुता को प्रकट करता है।
The second is what he calls alienation from the process of labour.	दूसरा वह है जिसे वह श्रम की प्रक्रिया से पराया कहता है।	दूसरा वह है जिसे वह श्रम की प्रक्रिया से अलगाव कहते हैं।	श्रम प्रक्रिया से विदेशीकरण वह कहता है कि दूसरा है।
In the process, Marx argued, workers become miserable.	प्रक्रिया में, मार्क्स ने दावा किया कि श्रमिक दुखी हो जाते हैं।	इस प्रक्रिया में, मार्क्स ने तर्क दिया, श्रमिक दुखी हो जाते हैं।	इस प्रक्रिया में, मार्क्स ने तर्क दिया कि मजदूर दुखी हो जाते हैं।
He asked the people to compare the scale of development in the adjoining Assam during eight years of BJP rule.	उन्होंने लोगों से अपने आसपास के असम में भाजपा की सरकार के आठ सालों के दौरान विकास के माप का तुलना करने के लिए कहा।	उन्होंने लोगों से अनुरोध किया कि वे बीजेपी के आठ साल के शासन के दौरान पड़ोसी असम में विकास के स्तर की तुलना करें।	वह लोगों से आठ साल के भाजपा शासन के दौरान आसाम में विकास के पैमाने की तुलना करने के लिए कहा।
The DMK MP also said that the Budget presented by Union Finance Minister Nirmala Sitharaman had neglected sectors such as education, health and agriculture.	डीएमके सांसद ने भी कहा कि केंद्रीय वित्त मंत्री निर्मला सीतारमण द्वारा पेश किया गया बजट शिक्षा, स्वास्थ्य और कृषि जैसे क्षेत्रों को ध्यान में नहीं रखता था।	डीएमके सांसद ने यह भी कहा कि केंद्रीय वित्त मंत्री निर्मला सीतारमण द्वारा प्रस्तुत बजट ने शिक्षा, स्वास्थ्य और कृषि जैसे क्षेत्रों की उपेक्षा की है।	डीएमके सांसद ने यह भी कहा कि केंद्रीय वित्त मंत्री निर्मला सीतारमण द्वारा प्रस्तुत बजट ने शिक्षा, स्वास्थ्य और कृषि जैसे क्षेत्रों की उपेक्षा की है।
The accident took place around 3 p.m. on a State highway close to Korar village.	हादसा लगभग 3 बजे दिन में हुआ था एक राज्य हाईवे पर कोरर गांव के पास।	दुर्घटना दोपहर लगभग 3 बजे राज्य राजमार्ग पर कोरार गाँव के पास हुई।	दुर्घटना करीब 3 बजे कोरार गांव के निकट राज्य राजमार्ग पर हुई।
Both the survivors are being treated at a hospital in Raipur.	दोनों सर्विवोर्स को रायपुर में एक अस्पताल में इलाज किया जा रहा है।	दोनों बचे हुए व्यक्तियों का रायपुर के एक अस्पताल में इलाज किया जा रहा है।	रायपुर में एक अस्पताल में दोनों सर्वाइवर्स का इलाज किया जा रहा है.
Chief Minister Bhupesh Baghel took to Twitter to express grief over the accident.	मुख्यमंत्री भूपेश बघेल ने दुर्घटना पर दुःख व्यक्त करने के लिए ट्विटर पर उतरा।	मुख्यमंत्री भूपेश बघेल ने दुर्घटना पर दुख व्यक्त करने के लिए ट्विटर का सहारा लिया।	मुख्यमंत्री भूपेश बघेल ने दुर्घटना पर शोक व्यक्त करने के लिए ट्विटर का सहारा लिया।
The Indian Institute of Technology Madras (IIT-M) Research Park hosted a competition for children.	भारतीय प्रौद्योगिकी संस्थान मद्रास (आईआईटी-एम) रिसर्च पार्क में बच्चों के लिए एक प्रतियोगिता आयोजित की गई।	भारतीय प्रौद्योगिकी संस्थान मद्रास (आईआईटी-एम) अनुसंधान पार्क ने बच्चों के लिए एक प्रतियोगिता का आयोजन किया।	भारतीय प्रौद्योगिकी संस्थान मद्रास (आईआईटी-एम) रिसर्च पार्क ने बच्चों के लिए एक प्रतियोगिता की मेजबानी की।
"External affairs minister S Jaishankar on Tuesday expressed concern over the attack on a Hindu temple in Canada, describing the incident as ""deeply concerning."	"मंत्री एस जयशंकर ने मंगलवार को कनाडा में एक हिंदू मंदिर पर हमले पर चिंता व्यक्त की, घटना को ""गहरी चिंता का विषय"" बताते हुए।"	"विदेश मंत्री एस जयशंकर ने मंगलवार को कनाडा में एक हिंदू मंदिर पर हुए हमले पर चिंता व्यक्त की और इस घटना को ""गहन चिंता का विषय"" बताया।"	"कनाडा में हिन्दू मंदिर पर हमले को लेकर मंगलवार को विदेश मंत्री एस जयशंकर ने गहरी चिंता व्यक्त की, इस घटना को ""अत्यंत चिंताजनक"" बताया।"
Modi condemns violence after Canada temple inciden.	मोदी कनाडा मंदिर हमले के बाद हिंसा की निंदा करते हैं।	मोदी ने कनाडा मंदिर घटना के बाद हिंसा की निंदा की।	मोदी ने कनाडा मंदिर घटना के बाद हिंसा की निंदा की।
Mr Nijjar had been a vocal supporter of the Khalistan movement and publicly campaigned for it.	मिस्टर निज्जर ने खालिस्तान आंदोलन के एक धीरज समर्थक रहे थे और इसके लिए सार्वजनिक रूप से प्रचार किया।	निज्जर जी खालिस्तान आंदोलन के प्रबल समर्थक थे और इसके लिए सार्वजनिक रूप से प्रचार किया करते थे।	श्री निज्जर खालिस्तान आंदोलन के मुखर समर्थक थे और इसके लिए सार्वजनिक अभियान चलाते थे।
Bangladesh steps up repayments to Adani to avoid power supply cu.	बांग्लादेश अदानी को चुकाने की गति बढ़ाते हैं ताकि वे बिजली आपूर्ति कटौती से बच सकें।	बांग्लादेश बिजली आपूर्ति में कटौती से बचने के लिए अडानी को भुगतान बढ़ा रहा है।	बांग्लादेश अदानी को चुकौती बढ़ाता है ताकि बिजली आपूर्ति कटौती से बचा जा सके।
The country is already suffering from increased power shortages in rural areas.	देश अब ग्रामीण क्षेत्रों में बढ़ी हुई ऊर्जा की कमी से पीड़ित है।	देश पहले से ही ग्रामीण क्षेत्रों में बढ़ती बिजली की कमी से जूझ रहा है।	ग्रामीण क्षेत्रों में बढ़ती बिजली की कमी से देश पहले से ही पीड़ित है।
Officials said 44 people were on board when the driver lost control and the bus fell into a 50m-deep ditch in Marchula, located in the state’s Almora district.	अधिकारी ने कहा कि जब ड्राइवर नियंत्रण खो दिया और बस मार्चुला में गिरने के लिए एक 50 मीटर गहरे खाई में गिर गई थी, तो बोर्ड पर 44 लोग थे, जो राज्य के अल्मोरा जिले में स्थित है।	अधिकारियों के अनुसार, जब चालक ने नियंत्रण खो दिया और बस राज्य के अल्मोड़ा जिले के मार्चुला में 50 मीटर गहरी खाई में गिर गई, तो बस में 44 लोग सवार थे।	अधिकारियों ने कहा कि मार्चुला में 50 मीटर गहरी खाई में बस गिरने से पहले चालक ने नियंत्रण खो दिया था और उस समय बस में 44 लोग सवार थे, जो अल्मोड़ा जिले में स्थित है.
Uttarakhand's Chief Minister Pushkar Singh Dhami has also announced financial assistance for the victims and their families.	उत्तराखंड के मुख्यमंत्री पुष्कर सिंह धामी ने पीड़ितों और उनके परिवारों के लिए वित्तीय सहायता की भी घोषणा की है।	उत्तराखंड के मुख्यमंत्री पुष्कर सिंह धामी ने पीड़ितों और उनके परिवारों के लिए वित्तीय सहायता की भी घोषणा की है।	उत्तराखंड के मुख्यमंत्री पुष्कर सिंह धामी ने पीड़ितों और उनके परिवारों के लिए आर्थिक सहायता की भी घोषणा की है।
Our scientists used it as an incentive to develop their own technology.	हमारे वैज्ञानिकों ने इसे अपनी तकनीक विकसित करने के लिए प्रोत्साहन के रूप में उपयोग किया।	हमारे वैज्ञानिकों ने इसे अपनी तकनीक विकसित करने के लिए एक प्रेरणा के रूप में उपयोग किया।	हमारे वैज्ञानिकों ने अपनी खुद की प्रौद्योगिकी विकसित करने के लिए इसे प्रोत्साहन के रूप में इस्तेमाल किया।
Mylswamy Annadurai, chief of India’s first and second Moon missions and Mars mission, told the BBC that Isro employs far fewer people and pays lower salaries, which makes Indian projects competitive.	मायलस्वामी अन्नादुराई, भारत की पहली और दूसरी चंद्रमा मिशन और मंगल मिशन के मुख्य हैं, ने बीबीसी को बताया कि इसरो में कम लोग काम करते हैं और कम वेतन मिलता है, जिससे भारतीय परियोजनाएं प्रतिस्पर्धी होती हैं।	माइलस्वामी अन्नादुरई, भारत के पहले और दूसरे चंद्रमा मिशन और मंगल मिशन के प्रमुख, ने बीबीसी को बताया कि इसरो कम कर्मचारियों को नियुक्त करता है और कम वेतन देता है, जिससे भारतीय परियोजनाएँ प्रतिस्पर्धात्मक बनती हैं।	मायलस्वामी अन्नादुरई, भारत के पहले और दूसरे चंद्र मिशन और मंगल मिशन के प्रमुख, ने बीबीसी को बताया कि इसरो में कम लोग काम करते हैं और कम वेतन दिया जाता है, जिससे भारतीय परियोजनाएं प्रतिस्पर्धी हो जाती हैं।
Ex-district president of Bajrang Dal Gurgaon held for shooting at Gurgaon man.	बजरंग दल गुड़गांव के पूर्व जिला अध्यक्ष को गुड़गांव में एक आदमी पर गोली चलाने के लिए गिरफ्तार किया।	बजरंग दल गुरुग्राम के पूर्व जिला अध्यक्ष को गुरुग्राम के व्यक्ति पर गोली चलाने के आरोप में गिरफ्तार किया गया।	बजरंग दल के पूर्व जिला अध्यक्ष गुरुग्राम के एक व्यक्ति पर गोली चलाने के आरोप में गिरफ्तार किया गया है.
The legendary Bob Khathing led the expedition to peacefully integrate Tawang into India.	भारत में तवांग को शांतिपूर्वक एकीकृत करने की अभियान में प्रसिद्ध बॉब खाथिंग ने अगुआ दिखाया।	दिग्गज बॉब खाथिंग ने तवांग को शांति से भारत में शामिल करने के अभियान का नेतृत्व किया।	महान बоб खातिंग ने भारत में तवांग के शांतिपूर्ण एकीकरण के लिए अभियान का नेतृत्व किया।
In 1939, after the Second World War broke out, Khathing joined the Indian Army and got an Emergency Commission as an officer.	1939 में, जब द्वितीय विश्व युद्ध शुरू हुआ, खाथिंग ने भारतीय सेना में शामिल होकर एक आपातकालीन कमीशन प्राप्त किया जैसे एक अधिकारी।	1939 में, जब द्वितीय विश्व युद्ध शुरू हुआ, खाथिंग भारतीय सेना में शामिल हो गए और उन्हें एक आपातकालीन कमीशन के रूप में अधिकारी नियुक्त किया गया।	१९३९ में, द्वितीय विश्व युद्ध के फूट पड़ने के बाद, खाथिंग ने भारतीय सेना में शामिल हो गए और एक अधिकारी के रूप में आपातकालीन आयोग प्राप्त किया।
At the end of the Second World War, the Emergency Commissioned officers in the Army were demobilised.	द्वितीय विश्व युद्ध के अंत में, सेना में आपत्कालीन आधिकारिकों को कार्यरत से निकाल दिया गया था।	द्वितीय विश्व युद्ध के अंत में, सेना में आपातकालीन नियुक्त अधिकारी निष्क्रिय कर दिए गए थे।	द्वितीय विश्व युद्ध के अंत में, सेना में आपातकालीन आयुक्त अधिकारियों को विसर्जित कर दिया गया।
Most of the senior cricketers were far from their best, especially against New Zealand.	अधिकांश वरिष्ठ क्रिकेट खिलाड़ी अपने सर्वोत्तम से दूर थे, खासकर न्यूजीलैंड के खिलाफ।	अधिकांश वरिष्ठ क्रिकेटर अपने सर्वश्रेष्ठ से काफी दूर थे, विशेष रूप से न्यूज़ीलैंड के खिलाफ।	अधिकांश वरिष्ठ क्रिकेटर अपने सर्वश्रेष्ठ से काफी दूर थे, विशेष रूप से न्यूजीलैंड के खिलाफ।
