src	gpt_3_5_trans	gpt_4o_trans	ollama_trans
JMM says Soren's helicopter take off delayed over PM's security protocol, writes to President Murmu	JMM म्हणते की सोरेनच्या हेलिकॉप्टरचा प्रधानमंत्रीच्या सुरक्षा नियमांच्या कारणे विलंबित केला, राष्ट्रपती मुर्मूला लिहिलं आहे।	JMM म्हणते की सोरेन यांच्या हेलिकॉप्टरचे उड्डाण पंतप्रधानांच्या सुरक्षा प्रोटोकॉलमुळे उशिरा झाले आहे, राष्ट्रपती मुर्मू यांना पत्र लिहिले आहे.	जेएमएम सांगते की, सोरेन यांचे हेलिकॉप्टरचे उड्डाण पंतप्रधानांच्या सुरक्षा प्रोटोकॉलमुळे विलंबित झाले, राष्ट्रपती मुर्मू यांना पत्र लिहिले.
The king who defied the British: Uncovering the tale of Pazhassi raja’s rebellion	ब्रिटिशांच्या विरोधात उतरणार्या राजाची कथा उघडणारा राजा: पाझसी राजांच्या विद्रोहाची कथा	ब्रिटिशांशी ज्या राजाने संघर्ष केला: पझ्हासी राजांच्या बंडाची कथा उलगडताना.	राजे ज्यांनी ब्रिटिशांचा विरोध केला: पझास्सी राजांच्या बंडाची कथा उघड करत आहोत
Vinesh Phogat's retirement U-turn predicted after her latest Instagram post creates buzz on social media	विनेश फोगाटची निवृत्ती U-टर्न त्यांच्या नवीन इंस्टाग्राम पोस्टने सोशल मीडियावर हलचल उत्पन्न करते, त्यानचे अनुमान लागते.	विनेश फोगाट यांच्या नवीनतम इंस्टाग्राम पोस्टमुळे सोशल मीडियावर चर्चेला उधाण आले आहे, त्यामुळे त्यांच्या निवृत्तीच्या निर्णयाबाबत पुन्हा विचार करण्याची शक्यता वर्तवली जात आहे.	विनेश फोगट यांच्या निवृत्तीच्या वळणाची अटकळ करण्यात आली आहे त्यांच्या नवीन इंस्टाग्राम पोस्टने सोशल मीडियावर खळबळ उडाली आहे.
The Pennsylvania push: Kamala Harris, Donald Trump spend final campaign hours in swing state	पेन्सिल्व्हेनिया पुश: कमला हॅरिस, डोनाल्ड ट्रंप स्विंग राज्यातील अंतिम निवडणूक तास व्यतीत करतात.	पेनसिल्व्हेनियाची धडक: कमला हॅरिस, डोनाल्ड ट्रम्प स्विंग राज्यात अंतिम प्रचार तास घालवतात.	पेन्सिल्व्हानिया पुश: कामाला हॅरिस, डोनाल्ड ट्रंप अंतिम प्रचार तास स्विंग स्टेटमध्ये व्यतीत करतात.
Delhi engulfed in smog, toxic foam in Yamuna: Pics that capture national capital's pollution woes	दिल्लीत कोहरा घालवून, यमुना नद्यात विषाक्त फोम: राष्ट्रीय राजधानीच्या प्रदूषणाच्या संकटांची छायाचित्रे	दिल्ली धुक्यात बुडाली, यमुनेत विषारी फेस: राष्ट्रीय राजधानीच्या प्रदूषणाच्या समस्यांचे चित्रण करणाऱ्या छायाचित्रांमध्ये.	दिल्ली धूम्रपानाने वेढली गेली आहे, यमुनेत विषारी फोम: राष्ट्रीय राजधानीच्या प्रदूषणाच्या वेदना टिपणाऱ्या चित्रां
Will Muslim boycott of Kamala send Trump to the White House?	कामाला याची मुस्लिम बॉयकॉट ट्रंपला सफरचंद्र घरात जाऊ शकेल का?	"""कमला यांच्या बहिष्कारामुळे मुस्लिमांनी ट्रम्प यांना व्हाईट हाऊसमध्ये पाठवणार का?"""	कमला ला मुस्लिमांचा बहिष्कार ट्रंपला व्हाइट हाउसवर पाठवील का?
Why Indian batters are struggling against left-arm spin	भारतीय बॅट्समन का वाम हाताच्या स्पिनर्सबाबत संघर्ष का होत आहे?	भारतीय फलंदाज डावखुऱ्या फिरकीविरुद्ध संघर्ष का करत आहेत?	भारतीय बॅट्समॅन लेफ्ट-आर्म स्पिन विरुद्ध का संघर्ष करत आहेत
JD Vance calls Kamala Harris 'trash' at Atlanta rally: 'In 2 days we're taking out the garbage'	जेडी व्हान्स एटलंटा रॅलीत कमला हॅरिसला 'कचरा' म्हणतो: '2 दिवसांत कचरा बाहेर काढतोय'	JD Vance यांनी Atlanta रॅलीमध्ये Kamala Harris यांना 'कचरा' म्हटले: '२ दिवसांत आम्ही कचरा बाहेर काढत आहोत'.	जे.डी. व्हान्स अटलांटा रॅलीमध्ये कमला हॅरिसला 'कचरा' म्हणतात: '२ दिवसांत आम्ही कचरा काढून टाकत आहोत'
Meghan and Harry feel life in US hasn't been what they expected: Ex-staff	मेघान आणि हॅरीने विचार केले आहे की अमेरिकेतील जीवन त्यांना अपेक्षित असले ते नाही: अॅक्झ-कर्मचाऱ्यांसाठी	मेघन आणि हॅरी यांना वाटतं की अमेरिकेतील जीवन त्यांच्या अपेक्षेप्रमाणे नसलं: माजी कर्मचारी	मेगन आणि हॅरी यांना अमेरिकेतील जीवन त्यांच्या अपेक्षेप्रमाणे नाही असे वाटते: माजी स्टाफ.
Elon Musk reacts to reports that he could be deported for immigration violation	एलॉन मस्कांनी प्रतिक्रिया दिली की त्याला प्रवास उल्लंघनाच्या कारणे नाकारणीसाठी निर्वासित केले जाऊ शकतो असं अहवालांवर प्रतिक्रिया दिली.	इलॉन मस्क यांच्या बद्दल असे अहवाल आले आहेत की, त्यांनी इमिग्रेशनचे नियम मोडले असल्यास त्यांना देशातून बाहेर काढले जाऊ शकते, यावर त्यांनी प्रतिक्रिया दिली आहे.	एलोन मस्क त्यांच्या वीजा उल्लंघनाबद्दल होणाऱ्या वृत्तपत्रांना प्रतिसाद देतात.
How China is lessening its reliance on helium sourced from US	कसे चीन अमेरिकेतून हेलियमची आधी घाती कमी करीत आहे, हे कसे आहे?	चीन अमेरिकेतून मिळणाऱ्या हीलियमवरील आपला अवलंब कमी कसा करत आहेत?	चीन अमेरिकेकडून मिळवलेल्या हेलियमवरील अवलंबन कमी करीत आहेत.
Kindle Colorsoft owners complain of a yellow bar on the e-reader’s screen	किंडल कलरसॉफ्ट व्यावसायिकांनी ई-रीडरच्या स्क्रीनवर पिवळा बार असल्याच्या तक्रार केल्या आहेत.	Kindle Colorsoft चे मालक ई-रीडरच्या स्क्रीनवर पिवळी पट्टी दिसल्याची तक्रार करतात.	कलरसॉफ्ट मालकांना ई-रीडरच्या स्क्रीनवर पिवळा बार याबद्दल तक्रार आहे.
Nvidia and its partners built a sophisticated system to bypass U.S. restrictions on exporting AI chips to the Middle East, Russia, and China.	न्विडिया आणि त्याचे साथीं अमेरिकेला ए.आय. चिप्सना मध्य पूर्व, रशिया आणि चीनला निर्यात करण्याच्या मर्यादांवर पार पडण्यासाठी एक उन्नत प्रणाली तयार केली.	Nvidia आणि त्यांच्या भागीदारांनी मध्य पूर्व, रशिया आणि चीनला AI चिप्स निर्यात करण्यावर असलेल्या यू.एस. मर्यादांना बगल देण्यासाठी एक अत्याधुनिक प्रणाली तयार केली आहे.	एन्वीडिया आणि त्यांचे साथीदारांनी अमेरिकेच्या मध्य पूर्व, रशिया आणि चीनला एआय चिप्स निर्यात करण्यावरील निर्बंध टाळण्यासाठी एक सुसज्जित व्यवस्था बांधली.
The funding, which will top up the firm’s flagship fund, will be raised primarily from institutional investors. 	संस्थांनी मुख्य निधीत कंपनीच्या प्रमुख निधीत वाढवणारी निधी जुळवणार आहे.	या निधीमुळे कंपनीच्या प्रमुख निधीमध्ये वाढ होईल आणि तो मुख्यत्वे संस्थात्मक गुंतवणूकदारांकडून उभारला जाईल.	ते निधी जे कंपनीच्या प्रमुख निधीस पूरक होतील, ते प्रामुख्याने संस्थात्मक गुंतवणूकदारांकडून उभारले जातील.
US Forest Service Decision to Halt Prescribed Burns in California is History Repeating	अमेरिकेच्या वन सेवेच्या निर्णयाने कॅलिफोर्नियातील प्रिस्क्रायब्ड बर्न्सवर थांबवण्याचा इतिहास पुन्हा अवघे करणार आहे.	अमेरिकेतील वन सेवा विभागाचा कॅलिफोर्नियामध्ये नियोजित आगींना थांबवण्याचा निर्णय हा इतिहासाची पुनरावृत्ती आहे.	अमेरिकेच्या वन सेवा विभागाने कॅलिफोर्नियामध्ये नियोजित अग्नि नियंत्रण कार्यक्रम थांबविण्याचा निर्णय इतिहासाची पुनरावृत्ती आहे.
The man who gave us the solution to the Entscheidungsproblem	आपल्याला Entscheidungsproblem समस्येचे निराकरण दिलेल्या व्यक्ती.	निर्णय समस्या सोडविण्याचे समाधान आम्हाला दिलेल्या व्यक्ती.	त्या मान्यांनी ज्यांनी आम्हाला Entscheidungsproblem चे उत्तर दिले
The shift in policy, covering government agencies and contractors working on national security, is intended to promote “responsible and ethical” innovations, the company said.	"सरकारची संस्था आणि राष्ट्रीय सुरक्षा वर कार्य करणारे ठेकेदार यांच्यावर लागू केलेल्या धोरणातील बदलाचा उद्दिष्ट उद्या म्हणते की ""जबाबदार आणि नैतिक"" नवीनतमपणे प्रोत्साहित करण्यात आले आहे."	"""शासकीय यंत्रणा आणि राष्ट्रीय सुरक्षेवर काम करणाऱ्या कंत्राटदारांना व्यापणाऱ्या धोरणातील बदल “जबाबदार आणि नैतिक” नवोपक्रमांना प्रोत्साहन देण्यासाठी आहे, असे कंपनीने म्हटले आहे."""	"कंपनीने सांगितले की, राष्ट्रीय सुरक्षेसाठी काम करणाऱ्या सरकारी संस्था आणि ठेकेदारांना व्यापत असलेली धोरणातील बदल ""जवाबदार आणि नैतिक"" नवकल्पनांना प्रोत्साहन देण्यासाठी आहे."
China reveals a new heavy lift rocket that is a clone of SpaceX’s Starship	चीनाने एक नवीन मोठ्या उच्च उडीद रॉकेट उघडली आहे, ज्याची SpaceXच्या स्टारशिपची क्लोन आहे.	चीनने SpaceX च्या स्टारशिपच्या प्रतिकृतीसारखा एक नवीन अवजड लिफ्ट रॉकेट उघड केला आहे.	चीनाने स्पेसएक्सच्या स्टारशिपचा क्लोन असलेला नवा भारी लिफ्ट रॉकेट उघडकीस आणला आहे.
Singapore requires vehicle owners to bid for a set number of Certificates of Entitlement – costly operating permits valid for only ten years.	सिंगापूरमध्ये वाहनांच्या मालकांना दस वर्षांसाठी मान्य असलेल्या उचित परवाने विकत घेण्याची आवश्यकता आहे - प्रमुख कार्य परवाने.	सिंगापूरमध्ये वाहन मालकांना मर्यादित संख्येच्या हक्क प्रमाणपत्रांसाठी लिलाव करावा लागतो - हे खर्चिक चालविण्याचे परवाने फक्त दहा वर्षांसाठी वैध असतात.	सिंगापूरमध्ये वाहन मालकांना दहा वर्षांच्या कालावधीसाठी वैध असलेल्या कार्यान्वित परवानग्यांच्या प्रमाणात प्रमाणपत्रे मिळविण्यासाठी बोली लावणे आवश्यक आहे.
The Hwasong-19 is North Korea’s biggest missile yet and its test comes during a time of notable tensions on the peninsula.	ह्वासोंग-19 उत्तर कोरियाचा सर्वात मोठा पारेशाण आहे आणि त्याची चाचणी किनारपट्टीवरील लक्षणांच्या काळात होते.	ह्वासॉंग-१९ हा उत्तर कोरियाचा आतापर्यंतचा सर्वात मोठा क्षेपणास्त्र आहे आणि त्याची चाचणी द्वीपकल्पावर उल्लेखनीय तणावाच्या काळात झाली आहे.	ह्वासोंग-१९ हे उत्तर कोरियाचे सर्वात मोठे क्षेपणास्त्र आहे आणि त्याची चाचणी पेनिन्सुलावरील उल्लेखनीय तणावाच्या काळात होत आहे.
The species may have been carried to the Sacramento–San Joaquin Delta in ballast water on ships	जातींचे गोटाळ्यातील पाण्याने जलयानांवर वाहून सॅक्रामेंटो-सॅन जोआकिन डेल्टात जाऊ शकते.	प्रजातींना जहाजांवरील पाण्याच्या संतुलनाद्वारे सॅक्रामेंटो-सॅन जोआक्विन डेल्टा येथे नेले गेले असावे.	जाती त्यांना शिप्सच्या बॅलस्ट वॉटरमध्ये सॅक्रामेंटो-सॅन जोक्विन डेल्टामध्ये नेल्या असण्याची शक्यता आहे.
Discovery partnered with PR firm Relevance International to produce ultra-luxury experiences and products under the banner of fictionaire billionaire Bruce Wayne’s conglomerate.	डिस्कव्हरीने पीआर फर्म रिलेव्हेन्स इंटरनॅशनलसोबत सहकार्य केले आहे, त्याने उल्ट्रा-लक्झरी अनुभव आणि उत्पादन ब्रूस वेनच्या संघटनेच्या धडधडीच्या ध्वनिविद बिलियनेअर ब्रूस वेनच्या संघटनेच्या धडधडीच्या व्यापारांच्या ताबडतोब्डे उत्पादन केले आहे.	डिस्कव्हरीने पीआर फर्म रिलेव्हन्स इंटरनॅशनलसोबत भागीदारी केली आहे ज्यामुळे काल्पनिक अब्जाधीश ब्रूस वेन यांच्या समूहाच्या नावाखाली अल्ट्रा-लक्झरी अनुभव आणि उत्पादने तयार केली जाऊ शकतील.	शोधाने रिलेव्हन्स इंटरनॅशनल या पीआर फर्मच्या साथीने फिक्शनेर बिलियनेर ब्रुस वेनच्या काँग्लोमरेटच्या बॅनरखाली अतिउच्च लक्झरी अनुभव आणि उत्पादने तयार केली.
Water utilities and chemical manufacturers are challenging the new EPA standards. 	पाणी सेवाप्रदात्यांच्या आणि रासायनिक उत्पादकांच्या बाबीत नवीन EPA मानकांचा संघर्ष आहे.	पाण्याच्या सेवासुविधा आणि रासायनिक उत्पादक नवीन EPA मानकांना आव्हान देत आहेत.	पाणी सुविधा आणि रासायनिक उत्पादक त्यांच्या नवीन ईपीए स्टँडर्ड्सचे आव्हान करत आहेत.
A radio station in Poland fired its on-air talent and brought in A.I.-generated presenters. An outcry over a purported chat with a Nobel laureate quickly ended that experiment.	पोलंडमधील एक रेडियो स्टेशनने आपल्या ऑन-एअर प्रतिभा नोकरी दूर केली आणि ए.आय.-ने उत्पन्न केलेल्या प्रस्तुतकर्त्यांना प्रवेश केलं. नोबेल विजेत्याशी संवाद करण्याच्या गोष्टीच्या कारणाने चाळणी उदंड झाली.	पोलंडमधील एका रेडिओ स्टेशनने त्यांच्या ऑन-एअर टॅलेंटला कामावरून काढून टाकले आणि A.I.-जनरेट केलेले प्रस्तुतकर्ता आणले. एका नोबेल पुरस्कार विजेत्या व्यक्तीसोबत झालेल्या चर्चेच्या कथित प्रकरणावरून झालेल्या तीव्र प्रतिक्रिया नंतर त्या प्रयोगाची लवकरच समाप्ती झाली.	पोलंडमधील एक रेडिओ स्टेशनने त्यांचे ऑन-एअर प्रतिभावान कलाकारांना कामावरून काढून टाकले आणि एआय-जनरेटेड संचालकांना आणले. नोबेल पुरस्कार विजेत्याशी झालेल्या संभाव्य संवादावरून त्वरित त्या प्रयोगाला अंत केला.
From infancy, children show heightened interest in events that are impossible or improbable, relative to likely events.	शिशुवयातीलपासून, लवकरात घडव्यात आणि असंभाव्य घडवयात, तुलनात्मकपर्यंत शिशुंनी उच्च आकर्षण दाखवतात.	लहानपणापासून, मुले अशक्य किंवा अशक्यप्राय घटनांमध्ये, शक्य घटनांच्या तुलनेत, अधिक रुची दाखवतात.	बालपणापासून, ते मुले असंभव किंवाल्पसंभव घटनांमध्ये वाढीव स्वारस्य दाखवतात, संभाव्य घटनांच्या तुलनेत.
Four persons were referred to hospital and the rest were treated as outpatients at the event venue, police sources said.	फोटोग्राफरांनी म्हणालं की चार व्यक्ती रुग्णालयात पाठविले गेले आणि शिल्लक स्थळावर उपचार केले गेले, पोलीस स्रोतांनी सांगितलं.	चार व्यक्तींना रुग्णालयात पाठविण्यात आले आणि उर्वरित व्यक्तींवर कार्यक्रम स्थळी बाह्य रुग्ण म्हणून उपचार करण्यात आले, असे पोलिस सूत्रांनी सांगितले.	चार व्यक्ती रुग्णालयात दाखल करण्यात आले आणि उर्वरीतांना स्थानिक स्थलावर बाह्य रुग्ण म्हणून व्यवस्था करण्यात आली, पोलीस स्रोतांनी सांगितले.
During investigation, the Washermenpet police found that he was attacked by three persons with stones and beer bottles while he was consuming alcohol.	तपशीलात, वाशरमेनपेट पोलिसांनी त्याला दारू प्यायला असताना तीन व्यक्त्यांद्वारे दागडीं आणि बियरच्या बोतल्यांकडून हल्ला केलेले आहे, असं आढळवून घेतलं.	चौकशीदरम्यान, वॉशरमेनपेट पोलिसांनी असे आढळून आले की, तो मद्यपान करत असताना त्यांच्यावर तीन व्यक्तींनी दगड आणि बिअरच्या बाटल्यांनी हल्ला केला.	तपासणीदरम्यान, वाशेरमेनपेटच्या पोलिसांनी असे आढळून आले की त्याला तीन व्यक्तींनी दगडांनी व बियरच्या बॉटलनी त्याच्या मद्यपान करत असताना हल्ला केला होता.
Two juvenile boys who were lodged at the Government Observation Home in Chengalpattu escaped on Tuesday night.	दुर्वयस्क दोघांना ज्यांच्यावर सरकारी अवलोकन घर, चेंगलपट्टूत ठेवले होते, त्यांना मंगळवार रात्री फरार झाले.	चेंगलपट्टू येथील सरकारी निरीक्षण गृहात ठेवलेले दोन किशोरवयीन मुले मंगळवारी रात्री पळून गेली.	दोन तरुण मुले जे चेंगलपट्टू येथील सरकारी निरीक्षण गृहात ठेवण्यात होते त्यांनी मंगळवार रात्री पलायन केले.
During Mr. Gandhi’s Srinagar stay, men disembarked from cars on Boulevard road to hug him.	गांधी सरकार्यालयाच्या सृनगर राहण्याच्या काळात, बुलेवार्ड रोडवरील कारांतून उतरून त्यांना आलंय.	श्री गांधींच्या श्रीनगर भेटीदरम्यान, बुलेवार्ड रस्त्यावर कारमधून उतरून पुरुषांनी त्यांना मिठी मारली.	श्री गांधींच्या श्रीनगर वास्तव्यादरम्यान, त्यांच्या Boulevard रस्त्यावरील गाड्यांमधून उतरलेल्या महानुभावांनी त्यांचे आलिंगन केले.
They alleged that several brick kilns started selling old stocks of bricks from Wednesday after paying the first instalment of the fine levied on them by the Geology and Mining Department.	त्यांनी दावा केलं की काही ईंटघरांनी बुधवारपासून जीवशास्त्र आणि खाणी विभागाने त्यांवर लागू केलेल्या दंडाची पहिली किश्ती भरून, जुन्या स्टॉक्सची विक्री सुरू केली.	त्यांनी असा आरोप केला की, भूविज्ञान आणि खनन विभागाने त्यांच्यावर लादलेल्या दंडाच्या पहिल्या हप्त्याचा भरणा केल्यानंतर अनेक वीटभट्ट्यांनी बुधवारपासून जुन्या वीटा विकण्यास सुरुवात केली.	त्यांनी आरोप केला की विभागाने त्यांच्यावर लादलेल्या दंडाचा पहिला हप्ता भरल्यानंतर बुधवारपासून काही इटक्या भट्ट्यांनी जुन्या इटक्यांच्या साठ्याची विक्री सुरू केली.
Ten Indian career diplomats, who are High Commissioners or Ambassadors of India in other countries, called on Governor R.N. Ravi at the Raj Bhavan in Chennai on Monday.	हा सोमवारी भारतातील इतर देशांमध्ये भारताचे उच्च आयुक्त किंवा दूतकारांचे उच्चाधिकारी राजभवनात राज्यपाल आर.एन. रवींना भेट देण्यासाठी आले.	दहा भारतीय करिअर राजनयिक, जे इतर देशांतील भारताचे उच्चायुक्त किंवा राजदूत आहेत, यांनी सोमवारी चेन्नईमधील राजभवनात राज्यपाल आर.एन. रवी यांची भेट घेतली.	दहा भारतीय कारकून राजदूत, जे भारताचे इतर देशांतील उच्च आयुक्त किंवा राजदूत आहेत, त्यांनी सोमवारी चेन्नई येथील राजभवनात राज्यपाल आर.एन. रवींची भेट घेतली.
However, Dr. Hande, who wrote the foreword for her book and took part in some of these Assembly debates, says Muthu discharged her duty efficiently as a Minister with no room for corruption.	मागचं, डॉ. हांडे, ज्यांनी तिच्या पुस्तकासाठी अग्रपत्रिका लिहिली आणि काही सभेत भाग घेतलं, म्हणजे मुथू एक नेते म्हणूनच तिच्या कर्तव्यांचे उत्तमपणे पालन केले असून कोरप्शनसाठी कोणतेही जागा नसलेले असे म्हणतात.	तथापि, डॉ. हांडे, जे त्यांच्या पुस्तकासाठी प्रस्तावना लिहिली आणि या काही विधिमंडळातील चर्चांमध्ये सहभागी झाले, असे म्हणतात की मुथु यांनी मंत्रिपदाची जबाबदारी सक्षमपणे पार पाडली आणि भ्रष्टाचाराला कोणतीही संधी दिली नाही.	पण डॉक्टर हांडे यांनी, ज्यांनी तिच्या पुस्तकासाठी प्रस्तावना लिहिली आणि या विधानसभा चर्चेत सहभागी झाले, असे म्हणतात की मuthu यांनी त्यांचे मंत्री म्हणून कार्य कुशलतेने पार पाडले आणि भ्रष्टाचारासाठी कोणतीही जागा नव्हती.
While both Mr. Lobo and Mr. Kamat have cited disaffection with the Congress high command as reasons, the true reasons are all too transparent.	गेल्या वर्षी मा. लोबो आणि मा. कामट दोघांनी काँग्रेसच्या मुख्य संभागाशी असंतोष दिलेलं असं कारण म्हणताना, खरे कारण सर्वच अत्यंत स्पष्ट आहेत.	श्री लोबो आणि श्री कामत यांनी काँग्रेस उच्च कमांडबद्दल असंतोष व्यक्त केल्याचे कारण दिले असले तरी, खरे कारणे अत्यंत स्पष्ट आहेत.	त्या दोघांपैकी श्री लोबो आणि श्री कामत यांनी काँग्रेस उच्च नेतृत्वाशी असंतोष म्हणून कारणे दिली आहेत, परंतु खरी कारणे सर्वस्वी स्पष्ट आहेत.
The first festival celebrating the linguistic and cultural ties between the Barak Valley region of Assam and the Sylhet segment of Bangladesh began on Friday evening.	असमाच्या बरकव्हॅली क्षेत्र आणि बांग्लादेशच्या सिल्हेट विभागातील भाषावैज्ञानिक आणि सांस्कृतिक जडण्याचा पहिला उत्सव शुक्रवारी सायंकाळी सुरू झाला.	आसामच्या बाराक खोऱ्यातील आणि बांगलादेशातील सिल्हेट भागातील भाषिक आणि सांस्कृतिक संबंधांचा उत्सव साजरा करणारा पहिला महोत्सव शुक्रवार संध्याकाळी सुरू झाला.	पहिला उत्सव आसामच्या बराक व्हॅली प्रदेश आणि बांगलादेशच्या सिलहट विभागातील भाषिक आणि सांस्कृतिक संबंध साजरा करण्यास सुरुवात झाली शुक्रवार संध्याकाळी.
The objective of such markets is to incentivise investments in renewable energy sources.	त्याच्या बाजारांच्या उद्दिष्ट हे नवीन ऊर्जा संशोधनांतील निवेशांच्या प्रोत्साहित करणे आहे.	अशा बाजारांचे उद्दिष्ट नवीकरणीय ऊर्जा स्रोतांमध्ये गुंतवणुकीला प्रोत्साहन देणे हे आहे.	त्या बाजारपेठांचे उद्देश्य हे पुनर्नवीकरणीय ऊर्जा स्रोतांमध्ये गुंतवणुकीला प्रोत्साहन देणे आहे.
The Centre is expected to clarify, later this year, the specifics of a carbon trading market in India.	केंद्राने भारतातील कार्बन व्यापाराच्या विशिष्टता प्रस्तावित करण्याची अपेक्षा आहे, या वर्षी उद्या स्पष्टीकरण करण्याची अपेक्षा आहे.	या वर्षाच्या उत्तरार्धात केंद्र सरकार भारतातील कार्बन व्यापार बाजारपेठेच्या तपशीलांविषयी स्पष्टता देण्याची अपेक्षा आहे.	केंद्रीय प्राधिकारी या वर्षात उर्जा व्यापार बाजाराच्या तपशीलांबाबत स्पष्टीकरण देण्याची अपेक्षा आहे.
Hydrogen is an essential industrial fuel that has a range of uses from producing ammonia.	हायड्रोजन हे एक आवश्यक औद्योगिक ईंधन आहे ज्याचा वापर अमोनिया उत्पादन करण्यापासून तोडायचे असते.	हायड्रोजन हे एक अत्यावश्यक औद्योगिक इंधन आहे ज्याचा ॲमोनिया निर्मितीपासून विविध उपयोग आहे.	हायड्रोजन हे औद्योगिक इंधन आहे ज्याचा वापर अमोनिया तयार करण्यासाठी आणि इतर अनेक कार्यांसाठी होतो.
Finance Minister Nirmala Sitharaman on Saturday said that regulators would do their job.	वित्त मंत्री निर्मला सीतारमण शनिवारी यांनी म्हणाली की नियंत्रक त्यांचे काम करतील.	शनिवारी वित्त मंत्री निर्मला सीतारामन म्हणाल्या की नियामक त्यांचे काम करतील.	आर्थिक मंत्री निर्मला सीतारामन यांनी शनिवारी सांगितले की नियामक त्यांचे काम करणार आहेत.
Madras has received a grant of ₹242 crore to do research on laboratory-grown diamonds.	मद्रासला प्रयोगशाळेत उत्पन्न केलेल्या हीरे वर अनुसंधान करण्यासाठी ₹२४२ कोटीची अनुदान मिळाली आहे.	मद्रासला प्रयोगशाळेत तयार केलेल्या हिऱ्यांवर संशोधन करण्यासाठी ₹242 कोटींचा अनुदान प्राप्त झाला आहे.	मद्रासला लॅबोरेटरीवर वाढवलेल्या हिरवळींवर संशोधन करण्यासाठी २४२ कोटी रुपयांचा अनुदान मिळाला आहे.
Before Rao took leave after the meeting, MGR gently reminded him of the Cauvery water.	मैयनेगर मीटिंग नंतर राव छुट्टी घेताना, एमजीआर त्यांना कावेरीच्या पाण्याची सुचना दिली.	राव साहेबांनी बैठकीनंतर निरोप घेण्यापूर्वी, एमजीआर यांनी त्यांना कोकणाची पाणी परिस्थिती नम्रपणे आठवण करून दिली.	राव साहेबांनी बैठकीनंतर सुट्टी घेतल्यापूर्वी, एमजीआर साहेबांनी त्यांना कावेरी पाण्याबद्दल सावधान केले.
It is because of this initiative that Tamil Nadu became the centre of higher learning.	ह्या प्रयत्नाने तमिळनाडू ह्या शिक्षणाच्या केंद्र म्हणून बनलं.	याच उपक्रमामुळे तामिळनाडू उच्च शिक्षणाचे केंद्र बनले.	त्यामुळे तमिळनाडू उच्च शिक्षणाचे केंद्र झाले आहे.
However, within minutes after the then Prime Minister intervened.	पण, त्यानंतर केवळ काही मिनिटांत पूर्व पंतप्रधान व्यवस्थापित होते.	तथापि, त्या वेळचे पंतप्रधानांनी हस्तक्षेप केल्यानंतर काही मिनिटांत.	पण त्या वेळी प्रधानमंत्र्यांनी हस्तक्षेप केल्यानंतर काही मिनिटांत.
The initial shock following the Taliban’s seizure of power in Kabul is waning.	काबुलमध्ये तालिबानच्या सत्ताकडून प्रारंभिक अचं शोक कमी होत आहे.	काबूलमधील तालिबानच्या सत्ताबदलानंतरचा प्रारंभिक धक्का कमी होत आहे.	तालिबानच्या काबुलवरील सत्ता अधिग्रहणानंतरच्या प्रारंभिक स्तब्धता कमी होत आहे.
The greatest impact of denial of rights for women in the workforce would be a sharp contraction in the economy.	महिलांच्या कामकाजातील हक्कांची तिरस्कार करण्याचा सर्वात मोठा परिणाम अर्थव्यवस्थेत एक तीव्र संकुचिती येईल.	कामकाजाच्या ठिकाणी महिलांच्या हक्कांच्या नाकारण्याचा सर्वात मोठा परिणाम म्हणजे अर्थव्यवस्थेत तीव्र घट होईल.	महिलांच्या कार्यबलातील हक्कांच्या नाकारातून सर्वात मोठा परिणाम अर्थव्यवस्थेतील तीव्र संकुचन होईल.
The Taliban do not shy from leveraging the issue to gain international attention.	तालिबान आंतरराष्ट्रीय लक्षात प्राप्त करण्यासाठी या मुद्द्याचा वापर करण्यास नकार नकरतात.	तालिबान आंतरराष्ट्रीय लक्ष वेधून घेण्यासाठी या मुद्द्याचा फायदा घेण्यास मागेपुढे पाहत नाहीत.	तालिबान त्या प्रश्नाचा वापर आंतरराष्ट्रीय लक्षवेध मिळविण्यासाठी केला नाही.
In Jammu and Kashmir, the enrolment dropped sharply from 1.78 lakh in 2019-20 to 1.31 lakh in 2020-21.	जम्मू आणि काश्मीरात, २०१९-२० मध्ये १.७८ लाखपासून २०२०-२१ मध्ये १.३१ लाखपर्यंत नोंदणी कमी झाली.	जम्मू आणि काश्मीरमध्ये, 2019-20 मध्ये 1.78 लाखांवरून 2020-21 मध्ये 1.31 लाखांवर प्रवेश संख्या तीव्रपणे कमी झाली आहे.	जम्मू आणि काश्मीरमध्ये, त्यांची नोंदणी २०१९-२० मध्ये १.७८ लाख वरून २०२०-२१ मध्ये १.३१ लाख एवढी घसरली.
Senior advocate Meenakshi Arora made the oral mentioning for early hearing.	वरिष्ठ वकील मीनाक्षी आरोरा लोकार्पणासाठी वेळेची सुनवाईसाठी मौखिक उल्लेख केला.	वरिष्ठ वकील मीनाक्षी अरोरा यांनी प्रकरणाच्या लवकर सुनावणीसाठी मौखिक उल्लेख केला.	वरिष्ठ वकील मीनाक्षी अरोरा यांनी लवकर सुनावणीसाठी तोंडी निवेदन केले.
The State had never forced students out of State schools by restricting hijab.	राज्याने कधीही हिजाबचा प्रतिबंध लागू करून राज्यशाळेतील विद्यार्थ्यांना बाहेर काढण्याचे आदेश दिले नाही.	राज्याने कधीही हिजाबवर निर्बंध लावून राज्यातील शाळांमधून विद्यार्थ्यांना बाहेर काढले नव्हते.	त्यांनी कधीही राज्य शाळांमधून विद्यार्थ्यांना हिजाबच्या मर्यादेमुळे बाहेर काढले नाही.
The patient has the right to refuse to participate in such research projects.	रुग्णांना ऐसे संशोधन प्रकल्पात सहभागी होण्याची नाकारात्मक प्रतिबंध करण्याचे हक्क आहे.	रुग्णाला अशा संशोधन प्रकल्पांमध्ये सहभागी होण्यास नकार देण्याचा अधिकार आहे.	रुग्णांना अशा संशोधन प्रकल्पांमध्ये सहभागी होण्यास नकार देण्याचा अधिकार आहे.
The field officials should remember it while implementing projects. 	क्षेत्रीय अधिकाऱ्यांनी प्रकल्प अमलात आणताना ह्याचा लक्ष ठेवावा लागेल.	प्रकल्प राबवताना क्षेत्रीय अधिकाऱ्यांनी हे लक्षात ठेवावे.	क्षेत्र अधिकारी त्यांनी प्रकल्प राबविताना हे लक्षात ठेवावे.
Senior officials in the Ministry of Tribal Affairs said a change in the structure had already been approved.	मराठीत वनजन कार्यालयातील वरिष्ठ अधिकारींनी संरचनेत बदल करण्याची परवानगी पहिल्यांदा दिली आहे.	आदिवासी कार्य मंत्रालयातील वरिष्ठ अधिकाऱ्यांनी सांगितले की, संरचनेत बदल करण्यास आधीच मंजुरी देण्यात आली आहे.	महामंडळातील वरिष्ठ अधिकारी म्हणाले की आदिवासी कार्य मंत्रालयातील संरचनेतील बदलाला आधीच मान्यता देण्यात आली आहे.
The Bhagwan Mahaveer Foundation has called for applications for the Mahaveer awards.	भगवान महावीर फाउंडेशनने महावीर पुरस्कारासाठी अर्जांची आवाहन केली आहे.	भगवान महावीर फाउंडेशनने महावीर पुरस्कारांसाठी अर्ज मागवले आहेत.	भागवान महावीर फाउंडेशनने महावीर पुरस्कारांसाठी अर्ज मागविले आहेत.
Mr. Yediyurappa resigned as Chief Minister and was succeeded by Basavaraj Bommai in 2020.	येदियुरप्पा सरकारप्रमुख म्हणून राजीनामा दिला आणि २०२० मध्ये त्यांच्या स्थानात बासवराज बोम्माई यांनी उत्तरदायित्व संभालला.	श्री येडियुरप्पा यांनी मुख्यमंत्री पदाचा राजीनामा दिला आणि २०२० मध्ये त्यांचे स्थान बसवराज बोम्माई यांनी घेतले.	श्री येदियुरप्पा त्यांनी मुख्यमंत्री पदाचा राजीनामा दिला आणि २०२० मध्ये त्यांच्यानंतर बसवराज बोम्मई त्यांचे उत्तराधिकारी झाले.
The rescuers had to cut the roof of the lift to bring them out, and nobody was hurt.	उद्धारक त्यांना बाहेर आणण्यासाठी लिफ्टच्या छत्राचा कापण करावा लागला होता, आणि कोणीही जखमी झालेला नव्हता.	"The rescuers had to cut the roof of the lift to bring them out, and nobody was hurt.

उद्धारकर्त्यांना त्यांना बाहेर आणण्यासाठी लिफ्टचे छत कापावे लागले, आणि कोणालाही इजा झाली नाही."	त्यांनी लिफ्टचा छत कापून त्यांना बाहेर काढले, आणि कोणालाही इजा झाली नाही.
The group claimed another police station attack in Rask that killed one officer on January 10.	जनवादी समूहने १० जानेवारीला रास्कमध्ये एक पोलिस थान्यावरील हल्ला केला आणि एक पोलिस अधिकारीला मारुन घातला असा दावा केला.	समूहाने रस्क येथील आणखी एका पोलीस ठाण्यावर करण्यात आलेल्या हल्ल्याची जबाबदारी स्वीकारली ज्यात १० जानेवारीला एक अधिकारी मृत्युमुखी पडले.	त्या गटाने रास्क येथे जानेवारी १० रोजी एका अधिकाऱ्याचा मृत्यू झालेला आणि पोलीस स्टेशनवरील आणखी एक हल्ला केल्याचा दावा केला.
Based on the complaint, an FIR has been registered against Constable Shailendra Singh and three other policemen.	तक्रारानुसार, कॉन्स्टेबल शैलेंद्र सिंग्ह आणि तिन्हो अन्य पोलीसांविरुद्ध एफआयआर दाखल केला गेला आहे.	तक्रारीच्या आधारे कॉन्स्टेबल शैलेन्द्र सिंह आणि इतर तीन पोलिसांविरुद्ध FIR नोंदवली गेली आहे.	त्या तक्रारीवरून, कॉन्स्टेबल शैलेंद्र सिंह यांच्या विरोधात आणि इतर तीन पोलीस अधिकाऱ्यांच्या विरोधात एफआयआर नोंदविण्यात आला आहे.
Financial institutions also play a crucial role in tracking the money trails sustaining these networks.	वित्तीय संस्थानांनी ही नेटवर्क्स संचालित करणाऱ्या धनाच्या मार्गांची तपासणीसाठी महत्वाच्या भूमिका आणतात.	आर्थिक संस्थाही या नेटवर्क्सना चालविणाऱ्या पैशांच्या मागोव्यासाठी महत्त्वाची भूमिका बजावतात.	आर्थिक संस्थाने देखील या नेटवर्क्सच्या पैसा ट्रेल्सच्या निरीक्षणात महत्त्वाची भूमिका बजावतात.
It is laudable that customs duties have been waived on three anti-cancer drugs.	खुप उत्तम आहे की तीन एंटी-कॅन्सर औषधांवर शुल्क माफ केले गेले आहे.	तीन कर्करोगविरोधी औषधांवरील सीमाशुल्क माफ करण्यात आले आहे, हे प्रशंसनीय आहे.	त्यांनी तीन कर्करोग विरोधी औषधींवरील सीमा शुल्क माफ केले असे प्रशंसनीय आहे.
Inside the final sprint in the biggest battleground state on the map.	मानचिन्हांवरील सर्वोत्तम लढाई राज्यातील अंतिम स्प्रिंटमध्ये आता.	नकाशावरील सर्वात मोठ्या रणांगण राज्यामध्ये अंतिम धावपटूंच्या आत.	आखरीच्या स्प्रिंटच्या आत महान लढाऊ राज्याच्या नकाशावर.
All eyes are on America as an uncertain world awaits election result.	सर्व डोळ्यांनी अमेरिकेला ध्यानात ठेवलं आहे, एक अनिश्चित जगात निवडणूकचा निर्णय वाटतंय.	संपूर्ण जग अमेरिकेकडे पाहत आहे कारण अनिश्चित जग निवडणुकीच्या निकालाची प्रतीक्षा करत आहे.	अमेरिकेच्या निवडणुकीच्या निकालाची वाट पाहत आहेत अशा अनिश्चित जगाची सर्व डोळे अमेरिकेकडे आहेत.
Twitch faces criticism over Israel-Gaza war content on platform.	त्विचवर इजरायल-गाझा युद्धाच्या विषयावर साहाय्यक आल्यामुळे ट्विचने आलोचना केली आहे.	Twitch या प्लॅटफॉर्मवरील इस्रायल-गाझा युद्धाच्या सामग्रीवर टीका होत आहे.	ट्विचला इस्रायल-गाजा युद्ध संबंधित प्लॅटफॉर्मवरील सामग्रीवर टीका स्वीकारावी लागत आहे.
North Korea fires multiple ballistic missiles toward the sea ahead of U.S. election.	उत्तर कोरिया संयुक्त राज्य निवडणुक्यापूर्वी समुद्राकडे अनेक बॉलिस्टिक मिसाइल फोडतं.	उत्तर कोरियाने अमेरिकेच्या निवडणुकीपूर्वी समुद्राकडे अनेक क्षेपणास्त्रे डागली आहेत.	उत्तर कोरियाने समुद्राकडे अमेरिकेच्या निवडणुकीच्या पूर्वसंध्येला अनेक बॅलिस्टिक मिसाइल्स सोडल्या.
Singapore Airlines will add first class, revamp cabins for longest flights.	सिंगापूर एअरलाइंसने सबसे लांब्या फ्लाइट्ससाठी पहिल्या वर्गाचे वाहन जोडणार आहेत, केबिन्स नवीन करणार आहेत.	सिंगापूर एअरलाइन्स त्यांच्या सर्वात लांब उड्डाणांसाठी प्रथम श्रेणी जोडतील आणि केबिनचे नूतनीकरण करतील.	सिंगापूर एरलाइन्स त्यांचे प्रथम वर्ग जोडणार आहेत, सर्वात लांब प्रवासासाठी केबिन्सचा नवीनीकरण करणार आहेत.
Priyanka Chopra Jonas and Nick Jonas celebrate 'Diwaloween,' Diwali and Halloween mashup.	प्रियंका चोप्रा जोनस आणि निक जोनस 'दिवालोव्हीन' साजरा करतात, दिवाळी आणि हॅलोवीनची मॅशअप.	प्रियंका चोप्रा जोनस आणि निक जोनस 'दिवालोवीन' म्हणजे दिवाळी आणि हॅलोवीनचा एकत्रित सण साजरा करतात.	प्रियांका चोप्रा जोनास आणि निक जोनास त्यांचे 'डिवालोवीन' साजरे करतात, दिवाळी आणि हॅलोवीनचा मिलाफ.
Pennsylvania officials denounce Halloween float appearing to depict Harris tied to golf cart.	Pennsylvania संस्थापक Halloween float निशाना देतात ज्यामध्ये Harris ने golf cart ला बांधलेला दाखवून देतात.	पेन्सिल्व्हेनियातील अधिकारी हॅलोवीन फ्लोटवर हरिसला गोल्फ कार्टशी बांधलेल्या अवस्थेत दर्शवताना दिसल्याबद्दल निषेध व्यक्त करतात.	पेन्सिल्व्हानिया अधिकारी हॅरिसला गोल्फ कार्टला बांधलेले दिसणारे हॅलोवीन फ्लोटची निंदा करतात.
Elon Musk's election-doubting posts shared 9 times more than his less extreme election content.	इलॉन मस्कच्या निवडणूकविषयीच्या पोस्ट्सचं त्याच्या कमी अतिरेकी निवडणूक सामग्रीपेक्षा ९ वेळा अधिक सामायिक केले गेले.	एलन मस्क यांच्या निवडणूक-संदर्भातील शंका उपस्थित करणाऱ्या पोस्ट्स त्यांच्या कमी तीव्र निवडणूक सामग्रीपेक्षा ९ पट अधिक वेळा शेअर केल्या गेल्या.	एलोन मस्क यांच्या निवडणूक-शंका पोस्ट्स त्यांच्या कमी अतिरेकी निवडणूक सामग्रीवर ९ पट जास्त वाटल्या होत्या.
Americans eye the economy from kitchen tables and hourly jobs as they plan their votes.	अमेरिकन्स त्यांच्या मतदानाची योजना करताना किचन टेबल्स आणि प्रत्येक तासाच्या कामांमध्ये अर्थव्यवस्थेच्या दिशेने पहा.	अमेरिकन लोक त्यांच्या मतांचे नियोजन करताना स्वयंपाकघराच्या टेबलांवरून आणि तासागणिक मिळणाऱ्या नोकऱ्यांवरून अर्थव्यवस्थेकडे लक्ष देतात.	अमेरिकन त्यांच्या अर्थव्यवस्थेकडे स्वयंपाकगृहाच्या टेबलवरून आणि तासिक नोकऱ्यांमधून त्यांची मते निश्चित करतात.
Quincy Jones, musical maestro and entertainment industry titan, dies at 91.	क्विंसी जोन्स, संगीत महामहिम आणि मनोरंजन उद्योग विशालकाय, ९१ वर्षांच्या वयाने मराठे जातात.	संगीत क्षेत्रातील महान गुरु आणि मनोरंजन उद्योगातील दिग्गज, क्विन्सी जोन्स, वयाच्या ९१व्या वर्षी निधन पावले.	क्विंसी जोन्स, संगीताचे महारथी आणि मनोरंजन उद्योगाचे दिग्गज, ९१ वर्षांचे वयात निधन पावले.
Proud Boys claim they'll be at polling places as Trump ups violent rhetoric and fraud claims	मंद लोक दावा करतात की ते जातीच्या स्थळांवर उपस्थित राहणार आहेत कारण ट्रंप द्वारे हिंसात्मक वाक्यसंग्रह आणि धोखाधडाव्या दावे वाढतील.	प्राउड बॉयज म्हणतात की ते मतदान केंद्रांवर उपस्थित राहतील कारण ट्रम्प हिंसक वक्तव्ये आणि फसवणूकीच्या दाव्यांना वाढ देत आहेत.	त्या पroud Boys ला म्हणतात की ते मतदान केंद्रांवर असतील जेव्हा त्रंप हिंसक भाषण व फसवणुकीच्या आरोपांचा प्रचार करतात.
One of the police officers stumbled to the ground when the driver applied brakes and attempted to strike him.	एका पोलीस अधिकाऱ्यांपैकी एक पोलीस अधिकाऱ्य ब्रेक लावल्यावर द्रायव्हर त्याला धक्का देण्याचा प्रयत्न केला आणि तो भूमिवर थोकला.	चालकाने ब्रेक लावले आणि त्यांना धक्का देण्याचा प्रयत्न केला तेव्हा पोलिस अधिकारी जमिनीवर कोसळले.	एक पोलीस अधिकारी त्यांना जमिनीवर कोसळले जेव्हा चालकाने ब्रेक लावले आणि त्यांच्यावर हल्ला करण्याचा प्रयत्न केला.
The authorities confirmed they have identified the vehicle's owner and expect to make an arrest shortly.	अधिकारी म्हणाले की त्यांनी वाहनाच्या मालकाची ओळख केली आहे आणि लवकरात लवक अटक करण्याची अपेक्षा आहे.	अधिकार्‍यांनी पुष्टी केली आहे की त्यांनी वाहनाच्या मालकाची ओळख पटवली आहे आणि लवकरच अटक करण्याची अपेक्षा आहे.	त्या अधिकार्‍यांनी त्यांनी वाहनाच्या मालकाची ओळख पटविली असून लवकरच अटक करण्याची अपेक्षा आहे.
The Chhatrapati Shivaji statue in the Arabian Sea off the Mumbai coast is referred to as a precedent for the proposed pen memorial.	मुंबई खाडीतील अरबी समुद्रातील छत्रपती शिवाजी दर्जाची मूर्ती, प्रस्तावित पेन स्मारकासाठी एक आधार म्हणून संदर्भित केली जाते.	मुंबईच्या किनाऱ्यावरील अरबी समुद्रातील छत्रपती शिवाजींची मूर्ती प्रस्तावित पेन स्मारकासाठी एक उदाहरण म्हणून संबोधली जाते.	छत्रपती शिवाजी Maharajांचा अरबी समुद्रात मुंबई किनारपट्टीवरील पुतळा प्रस्तावित पेन स्मारकासाठी आदर्श म्हणून ओळखला जातो.
Several political parties have opposed the pen memorial in the proposed location.	काही राजकीय पक्षांनी सुचवलेल्या ठिकाणी लेखनाची स्मारकाची विरोध केली आहे.	प्रस्तावित ठिकाणी पेन स्मारकाला अनेक राजकीय पक्षांनी विरोध केला आहे.	अनेक राजकीय पक्षांनी प्रस्तावित स्थानावरील कलम स्मारकाला विरोध केला आहे.
They have not taken into consideration the rainfall data of 2015 or years thereafter. 	त्यांनी २०१५ वर्षाच्या नंतरच्या वर्षाची माहिती विचारात घेतली नाही.	त्यांनी २०१५ किंवा त्यानंतरच्या वर्षांच्या पर्जन्यमानाच्या आकडेवारीचा विचार केलेला नाही.	त्यांनी २०१५ च्या किंवा त्यानंतरच्या वर्षांचे पावसाचे आकडे विचारात घेतले नाहीत.
The museum has been equipped with multimedia content, QR codes and holograms.	संग्रहालयात मल्टिमिडिया कंटेंट, क्यूआर कोड आणि होलोग्राम्ससह सुसज्जित केले गेले आहे.	संग्रहालयाला मल्टिमीडिया सामग्री, QR कोड्स आणि होलोग्राम्सने सुसज्ज केले आहे.	त्यांनी संग्रहालयाला मल्टिमीडिया सामग्री, क्यूआर कोड आणि होलोग्राम्सनी सुसज्जित केले आहे.
The ninth phase of the excavations would begin later this month, said officials.	अधिकारी म्हणाले की उद्घाटनाच्या नव्या चरणाचा उद्घाटन या महिन्यातच होईल.	अधिकाऱ्यांनी सांगितले की, उत्खननाच्या नवव्या टप्प्याला या महिन्याच्या शेवटी सुरुवात होईल.	नवव्या टप्प्यातील उत्खनने या महिन्याच्या उत्तरार्धात सुरू होतील, असे अधिकारी म्हणतात.
Mr. Reddy is a close relative of Taraka Ratna's wife Alekya Reddy.	"""श्री रेड्डी तारका रत्नांच्या पत्नी अलेक्या रेड्डीचे निकट संबंधी आहेत."""	श्री रेड्डी हे तारक रत्न यांच्या पत्नी आलेख्या रेड्डी यांच्या निकटच्या नातेवाईकांपैकी आहेत.	श्रीमान रेड्डी हे तारका रत्नाच्या पत्नी अलेक्या रेड्डी यांचे नातेवाईक आहेत.
This betrays an inexplicable hostility towards knowledge creation of all kinds. 	यात सर्व प्रकारच्या ज्ञानसृष्टीवर अकारण शत्रूता दाखवते.	हे सर्व प्रकारच्या ज्ञाननिर्मितीबद्दलच्या अनाकलनीय शत्रुत्वाला प्रकट करते.	हे सर्व प्रकारच्या ज्ञान निर्मितीच्या प्रति अस्पष्ट वैर व्यक्त करते.
The second is what he calls alienation from the process of labour.	तुम्ही तुमच्या कामची प्रक्रियेतून परदेशातून अलगवज़ा असे तो म्हणतो.	दुसरे म्हणजे ते ज्याला श्रम प्रक्रियेपासून疏離करण म्हणतात.	ते दुसरे म्हणजे त्यांचे कामाच्या प्रक्रियेपासून परकीयकरण होय.
In the process, Marx argued, workers become miserable.	या प्रक्रियेत, मार्क्स वाद दिल्या की, कर्मचारी दुःखी होतात.	या प्रक्रियेत, मार्क्स यांनी सांगितले की, कामगार दुःखी होतात.	त्या प्रक्रियेत, मार्क्स यांनी तर्क केला की कामगार मiserable होतात.
He asked the people to compare the scale of development in the adjoining Assam during eight years of BJP rule.	त्यांनी मानवांना विनंती केली की अँगठ्यावरील आसाममध्ये भाजपा शासनाच्या आठ वर्षांच्या काळात विकासाचे माप तुलना करण्याची.	त्यांनी लोकांना आठ वर्षांच्या भाजपच्या राजवटीदरम्यान शेजारील आसाममधील विकासाच्या प्रमाणाची तुलना करण्यास सांगितले.	त्यांनी लोकांना आसाममधील आठ वर्षांच्या भाजप सरकारच्या कालावधीतील विकासाच्या प्रमाणाची तुलना करण्यास सांगितले.
The DMK MP also said that the Budget presented by Union Finance Minister Nirmala Sitharaman had neglected sectors such as education, health and agriculture.	DMK एमपीही त्यात आणि संघीय वित्त मंत्री निर्मला सीतारमण द्वारे पेश केलेले बजेट शिक्षण, आरोग्य आणि कृषी अशा क्षेत्रांचा उपेक्षा केलेला आहे, असं सांगितलं.	डीएमकेचे खासदार असेही म्हणाले की केंद्रीय वित्त मंत्री निर्मला सीतारामन यांनी सादर केलेल्या अर्थसंकल्पात शिक्षण, आरोग्य आणि शेती यांसारख्या क्षेत्रांकडे दुर्लक्ष करण्यात आले आहे.	डीएमके सांसदांनीही म्हटले की केंद्रीय अर्थमंत्री निर्मला सीतारामन यांनी सादर केलेल्या अर्थसंकल्पात शिक्षण, आरोग्य आणि कृषी या क्षेत्रांना दुर्लक्ष केले आहे.
The accident took place around 3 p.m. on a State highway close to Korar village.	काही वेळेच्या वेळी एक राज्यीय हायवे जवळच्या कोरर गावावर एक दुर्घटना घडली.	अपघात दुपारी ३ वाजता कोरार गावाजवळील राज्य महामार्गावर झाला.	आकस्मिक अपघात साधारणपणे ३ वाजता राज्य महामार्गावर कोरार गावाजवळ झाला.
Both the survivors are being treated at a hospital in Raipur.	आपल्या दोन उर्वारा रायपुरातील एक रुग्णालयात उपचारात आहेत.	रायपूरमधील रुग्णालयात दोन्ही वाचलेल्यांवर उपचार केले जात आहेत.	ते दोन जखमी रायपूर येथील एका रुग्णालयात उपचार घेत आहेत.
Chief Minister Bhupesh Baghel took to Twitter to express grief over the accident.	मुख्यमंत्री भूपेश बघेल ट्विटरवर दु:खाच्या भावना व्यक्त करण्यासाठी ग्राहकांचा वापर केला.	मुख्यमंत्री भूपेश बघेल यांनी अपघाताबद्दल दुःख व्यक्त करण्यासाठी ट्विटरचा वापर केला.	मुख्यमंत्री भूपेश बघेल यांनी ट्विटरवर दुर्घटनेवर शोक व्यक्त केला.
The Indian Institute of Technology Madras (IIT-M) Research Park hosted a competition for children.	भारतीय प्रौद्योगिकी संस्थान मद्रास (आयआयटी-एम) रिसर्च पार्कने मुलांसाठी एक प्रतियोगिता आयोजित केली.	भारतीय तंत्रज्ञान संस्था, मद्रास (आयआयटी-एम) संशोधन उद्यान यांनी मुलांसाठी एक स्पर्धा आयोजित केली.	भारतीय तंत्रज्ञान संस्था मद्रास (आयआयटी-एम) संशोधन पार्कने बालांसाठी स्पर्धा आयोजित केली.
"External affairs minister S Jaishankar on Tuesday expressed concern over the attack on a Hindu temple in Canada, describing the incident as ""deeply concerning."	"सोमवारीच्या दिवशी बाह्य कार्य मंत्रिमंडळीवरील एस जयशंकर ने कॅनडातील एक हिंदू मंदिरवरील हल्ल्यावर चिंता व्यक्त केली, या घटनेवर ""गंभीर चिंताजनक"" असे वर्णन केले."	"मंगलवारी परराष्ट्र मंत्री एस. जयशंकर यांनी कॅनडामधील हिंदू मंदिरावर झालेल्या हल्ल्याबद्दल चिंता व्यक्त केली आणि या घटनेचा ""गंभीर विचार करण्याजोगा"" असा उल्लेख केला."	"विदेश मंत्र्यांनी मंगळवारी कॅनडामधील हिंदू मंदिरावरील हल्ल्याबद्दल चिंता व्यक्त केली, ही घटना ""अत्यंत चिंताजनक"" असल्याचे सांगितले."
Modi condemns violence after Canada temple inciden.	मोदी ने कॅनडा देवस्थान घटनेनंतर हिंसेची निंदा केली.	मोदी कॅनडातील मंदिराच्या घटनेनंतर हिंसाचाराचा निषेध करतात.	मोदी त्यांनी कॅनडा मंदिर प्रकरणानंतर हिंसाचाराची निंदा केली.
Mr Nijjar had been a vocal supporter of the Khalistan movement and publicly campaigned for it.	निज्जर सरांनी खालिस्तान आंदोलनाचा सक्रिय समर्थक होता आणि त्याने त्यासाठी सार्वजनिकपणे अभियान चालवला.	श्री निज्जर हे खलिस्तान चळवळीचे प्रखर समर्थक होते आणि त्यांनी तिच्यासाठी सार्वजनिकरित्या प्रचार केला होता.	श्री निज्जार साहेबांनी खालिस्तान चळवळीचे प्रबल समर्थक होते आणि त्यासाठी सार्वजनिकपणे प्रचार केला होता.
Bangladesh steps up repayments to Adani to avoid power supply cu.	बांग्लादेश अदानीला विद्युत आपूर्ती संकट टाळण्यासाठी कर्जाची तितकी करत आहे.	बांगलादेश वीजपुरवठा कपात टाळण्यासाठी अदानींना परतफेड वाढवित आहात.	बांगलादेश आदानीला कर्ज फेडण्यासाठी वीज पुरवठा कात टाळण्यासाठी पावले वाढवत आहेत.
The country is already suffering from increased power shortages in rural areas.	देशात शांतता वळवण्याची समस्या आधीच गावीकडच्या क्षेत्रांमध्ये वाढत आहे.	गावाकडील भागांमध्ये वाढलेल्या वीजटंचाईमुळे देश आधीच त्रास सहन करत आहे.	देशाला ग्रामीण भागात वाढत्या विजेच्या टंचाईचा सामना करावा लागत आहे.
Officials said 44 people were on board when the driver lost control and the bus fell into a 50m-deep ditch in Marchula, located in the state’s Almora district.	अधिकाऱ्यांनी सांगितलं की ड्रायव्हरांनी नियंत्रण गमावून दर्जेदारीच्या अल्मोरा जिल्ह्यातील मार्चूला येथील ५० मीटर गहिरे घाटात बस गिळ्यात पडली वेळेवर ४४ लोकांसह त्या बसात आले होते.	अधिकाऱ्यांनी सांगितले की, राज्याच्या अल्मोरा जिल्ह्यातील मार्चुला येथे चालकाचा ताबा सुटला आणि बस ५० मीटर खोल खड्यात कोसळली, तेव्हा ४४ लोक बसमध्ये होते.	अधिकारी म्हणाले की बसमध्ये ४४ जण चालले होते जेव्हा चालकाने नियंत्रण सोडले आणि बस मार्चुला येथील अल्मोरा जिल्ह्यातील ५० मीटर खोल गटारात पडली.
Uttarakhand's Chief Minister Pushkar Singh Dhami has also announced financial assistance for the victims and their families.	उत्तराखंडाचे मुख्यमंत्री पुष्कर सिंह धामीने पीडितांच्या आणि त्यांच्या कुटुंबांसाठी आर्थिक सहाय्य घोषित केलं आहे.	उत्तराखंडचे मुख्यमंत्री पुष्कर सिंह धामी यांनी पीडितांना आणि त्यांच्या कुटुंबीयांना आर्थिक मदतीची घोषणा केली आहे.	उत्तराखंडचे मुख्यमंत्री पुष्कर सिंह धामी यांनीही पीडितांच्या व त्यांच्या कुटुंबीयांसाठी आर्थिक मदत जाहीर केली आहे.
Our scientists used it as an incentive to develop their own technology.	आमचे वैज्ञानिक आपल्या खात्यात त्याचा वापर करून त्यांच्या स्वतःच्या तंत्रज्ञानाची विकास केली.	आमच्या वैज्ञानिकांनी त्यांचा स्वतःचा तंत्रज्ञान विकसित करण्यासाठी याचा प्रोत्साहन म्हणून वापर केला.	त्यांचे वैज्ञानिक त्याला प्रोत्साहन म्हणून त्यांची स्वकीय तंत्रज्ञान विकसित करण्यासाठी वापरले.
Mylswamy Annadurai, chief of India’s first and second Moon missions and Mars mission, told the BBC that Isro employs far fewer people and pays lower salaries, which makes Indian projects competitive.	मैल्सवामी अन्नादुरै, भारताच्या पहिल्या आणि दुसऱ्या चंद्रमा मिशन्स आणि मंगळ मिशनचे मुख्य, बीबीसीला सांगितलं की इसरो संख्येने अधिक कमी करते आणि कमी वेतने देते, ज्यामुळे भारतीय प्रकल्प स्पर्धात्मक बनवतात.	मायलस्वामी अन्नादुराई, भारताच्या पहिल्या आणि दुसऱ्या चंद्र मोहिमा आणि मंगळ मोहिमेचे प्रमुख, यांनी बीबीसीला सांगितले की इस्रो कमी लोकांना नोकरी देते आणि कमी पगार देते, ज्यामुळे भारतीय प्रकल्प स्पर्धात्मक ठरतात.	मीलस्वामी अन्नादुरई, भारताच्या प्रथम आणि द्वितीय चंद्रमissionचे प्रमुख आणि मंगळ मिशनचे प्रमुख, बीबीसीला सांगितले की इस्रो कमी लोकांना रोजगार देते आणि कमी वेतन देते, ज्यामुळे भारतीय प्रकल्प स्पर्धात्मक होतात.
Ex-district president of Bajrang Dal Gurgaon held for shooting at Gurgaon man.	गुरुगावातील गुरुगाव युवकावर गोली काढण्यात आणणारे बजरंग दलाच्या जिल्हाध्यक्षांनी गुरुगावातील पुराने जिल्हाध्यक्षांच्या पदाधिकाऱ्यांनी पकडले.	बजरंग दल गुरगावचे माजी जिल्हाध्यक्ष गुरगावमधील व्यक्तीवर गोळीबार केल्याबद्दल अटक करण्यात आली आहे.	बजरंग दलाचे माजी जिल्हा अध्यक्ष गुरगावचे त्या गुरगावकरांवर गोळीबार करण्यासाठी अटक करण्यात आले.
The legendary Bob Khathing led the expedition to peacefully integrate Tawang into India.	महान बॉब खाथिंग यांनी तावंग भारतात समाहित करण्यासाठी अभियान नेत्यांच्या मार्गदर्शनाखाली लढवलं.	प्रसिद्ध बॉब खाथिंग यांनी तवांगला शांततेत भारतात समाविष्ट करण्याच्या मोहिमेचे नेतृत्व केले.	भारतीय अधिकाऱ्यांनी शांततापूर्ण रीतीने तवांगचा भारतात समावेश करण्यासाठी प्रसिद्ध बोब खातिंग यांचे नेतृत्व होते.
In 1939, after the Second World War broke out, Khathing joined the Indian Army and got an Emergency Commission as an officer.	इ.स. १९३९ मध्ये, द्वितीय विश्व युद्ध सुरू झाल्यानंतर, खाथिंग भारतीय सेनेत सामील झाले आणि एक अधिकारीस्थानाची आपातकालीन कमिशन मिळाली.	१९३९ मध्ये, दुसरे महायुद्ध सुरू झाल्यानंतर, खाथिंग यांनी भारतीय सैन्यात सामील होऊन अधिकारी म्हणून एक आपत्कालीन आयोग प्राप्त केला.	१९३९ मध्ये, दुसऱ्या महायुद्धाचा प्रारंभ झाल्यानंतर, खाथिंगांनी भारतीय सेनेत प्रवेश केला आणि त्यांना ऑफिसर म्हणून आपत्कालीन आयोग मिळाला.
At the end of the Second World War, the Emergency Commissioned officers in the Army were demobilised.	दुसर्या विश्वयुद्धाच्या शेवटी, सेनेतील आपत्कालीन कमीशनदारंची रक्षणार्थ सैनिकांना वाजवले गेले.	द्वितीय महायुद्धाच्या शेवटी, सैन्यातील आपत्कालीन नियुक्त अधिकारी निवृत्त करण्यात आले.	दुसऱ्या महायुद्धाच्या शेवटी, सेनेतील त्या आपत्कालीन अधिकारी महाशयांना मुक्त करण्यात आले.
Most of the senior cricketers were far from their best, especially against New Zealand.	अधिकांश वरिष्ठ क्रिकेटर त्यांच्या सर्वोत्तमपेक्षा दूर होते, विशेषतः न्यूझीलंडविरुद्ध.	अधिकांश वरिष्ठ क्रिकेटपटू त्यांच्या सर्वोत्तम कामगिरीपासून दूर होते, विशेषतः न्यूझीलंडविरुद्ध.	महत्त्वाचे सगळे ज्येष्ठ क्रिकेटपटू त्यांच्या सर्वोत्तमपासून दूर होते, विशेषतः न्यू झीलंडविरुद्ध.
