src	gpt_3_5_trans	gpt_4o_trans	ollama_trans
JMM says Soren's helicopter take off delayed over PM's security protocol, writes to President Murmu	JMM कहती है कि सोरेन के हेलीकॉप्टर का उड़ान लंबित है पीएम की सुरक्षा प्रोटोकॉल के कारण, राष्ट्रपति मुर्मू को लिखती है।	झारखंड मुक्ति मोर्चा (जेएमएम) कहता है कि सोरेन के हेलीकॉप्टर का उड़ान भरना प्रधानमंत्री की सुरक्षा प्रोटोकॉल के कारण विलंबित हुआ, उन्होंने राष्ट्रपति मुर्मू को पत्र लिखा।	जेएमएम का कहना है कि प्रधानमंत्री की सुरक्षा प्रोटोकॉल के कारण सोरेन के हेलीकॉप्टर के उड़ान में देरी हुई, राष्ट्रपति मुर्मू को पत्र लिखते हैं।
The king who defied the British: Uncovering the tale of Pazhassi raja’s rebellion	जो ब्रिटिश का सामना किया राजा: पाझसी राजा के विद्रोह की कहानी उजागर करना	ब्रिटिशों को चुनौती देने वाले राजा: पज़्हासी राजा के विद्रोह की कहानी को उजागर करना।	वे राजा जिन्होंने ब्रिटिश की चुनौती दी: पज़हस्सी राजा के विद्रोह की कहानी का अनावरण
Vinesh Phogat's retirement U-turn predicted after her latest Instagram post creates buzz on social media	विनेश फोगाट के नवीनतम इंस्टाग्राम पोस्ट के चर्चा सोशल मीडिया पर धूम मचा देने के बाद, हमने उनके सेवानिवृत्ति की उम्मीद जताई है।	विनेश फोगाट के रिटायरमेंट के फैसले को बदलने की संभावना उनके नवीनतम इंस्टाग्राम पोस्ट के बाद सोशल मीडिया पर चर्चा का विषय बन गई है।	विनेश फोगाट के सेवानिवृत्ति के यू-टर्न की भविष्यवाणी उनके नवीनतम इंस्टाग्राम पोस्ट द्वारा सोशल मीडिया पर हलचल पैदा होने के बाद की गई है।
The Pennsylvania push: Kamala Harris, Donald Trump spend final campaign hours in swing state	पेन्सिल्वेनिया पश्चिम धक्का: कमला हैरिस, डोनाल्ड ट्रंप अंतिम प्रचार की घंटों का समय स्विंग राज्य में बिताते हैं।	पेंसिल्वेनिया की ओर ध्यान: कमला हैरिस, डोनाल्ड ट्रंप ने स्विंग राज्य में अंतिम प्रचार घंटे बिताए।	पेंसिल्वेनिया पुश: कमला हैरिस, डोनाल्ड ट्रंप उनके अंतिम प्रचार घंटे स्विंग राज्य में व्यतीत कर रहे हैं।
Delhi engulfed in smog, toxic foam in Yamuna: Pics that capture national capital's pollution woes	दिल्ली में स्मॉग में लिपटा हुआ, यमुना में विषैला फोम: तस्वीरें जो राष्ट्रीय राजधानी की प्रदूषण समस्याओं को दर्शाती हैं।	दिल्ली धुएं में लिपटी, यमुना में जहरीला झाग: तस्वीरें जो राष्ट्रीय राजधानी की प्रदूषण समस्याओं को दर्शाती हैं।	दिल्ली में स्मॉग ने घेर लिया, यमुना में जहरीला फोम: राष्ट्रीय राजधानी की प्रदूषण समस्याओं को कैप्चर करने वाली तस्वीरें
Will Muslim boycott of Kamala send Trump to the White House?	क्या मुस्लिम की कमाला के विरोध से ट्रंप को सफेद घर भेज देगा?	क्या मुस्लिमों का कमला का बहिष्कार ट्रम्प को व्हाइट हाउस भेज देगा?	क्या कामला के मुसलमानों द्वारा बहिष्कार ट्रंप को व्हाइट हाउस भेज देगा?
Why Indian batters are struggling against left-arm spin	भारतीय बैटसमैन वाम हाथ के स्पिनर्स के खिलाफ संघर्ष क्यों कर रहे हैं?	भारतीय बल्लेबाज़ बाएं हाथ के स्पिन के खिलाफ संघर्ष क्यों कर रहे हैं?	भारतीय बल्लेबाज़ लेफ्ट-आर्म स्पिन के विरुद्ध संघर्ष क्यों कर रहे हैं?
JD Vance calls Kamala Harris 'trash' at Atlanta rally: 'In 2 days we're taking out the garbage'	JD Vance अटलांटा रैली में Kamala Harris को 'कचरा' कहते हैं: '2 दिनों में हम कचरा बाहर निकाल रहे हैं'।	जेडी वांस ने अटलांटा रैली में कमला हैरिस को 'कचरा' कहा: 'दो दिन में हम कचरा बाहर निकाल रहे हैं'	जेडी वैन्स ने अटलांटा रैली में कमला हैरिस को 'कचरा' कहा: '2 दिन में हम कचरे को हटा रहे हैं'
Meghan and Harry feel life in US hasn't been what they expected: Ex-staff	Meghan और Harry को लगता है कि अमेरिका में जीवन वह नहीं था जैसा उन्होंने अपेक्षा की थी: पूर्व कर्मचारी।	मेघन और हैरी महसूस करते हैं कि अमेरिका में जीवन वैसा नहीं रहा जैसा उन्होंने अपेक्षा की थी: पूर्व कर्मचारी	मेगन और हैरी का कहना है कि अमेरिका में जीवन उनकी उम्मीदों के मुताबिक नहीं रहा है: पूर्व-स्टाफ सदस्यों ने कहा।
Elon Musk reacts to reports that he could be deported for immigration violation	एलॉन मस्क उस रिपोर्ट्स के प्रति प्रतिक्रिया दिखा रहे हैं जिसके अनुसार उन्हें विस्थापित किया जा सकता है आप्रवासन उल्लंघन के लिए।	एलन मस्क ने उन रिपोर्टों पर प्रतिक्रिया दी है कि वे आव्रजन उल्लंघन के लिए निर्वासित किए जा सकते हैं।	एलोन मस्क ने आव्रजन उल्लंघन के लिए उनकी निर्वासन की खबरों पर प्रतिक्रिया व्यक्त की।
How China is lessening its reliance on helium sourced from US	कैसे चीन उस से हेलियम पर अपनी आवश्यकता कम कर रहा है, यह कैसे है?	कैसे चीन अमेरिका से प्राप्त हीलियम पर अपनी निर्भरता कम कर रहे हैं।	चीन अमेरिका से प्राप्त हीलियम पर अपनी निर्भरता कम कर रहे हैं।
Kindle Colorsoft owners complain of a yellow bar on the e-reader’s screen	Kindle Colorsoft owners का शिकायत है कि ई-रीडर की स्क्रीन पर पीला पट्टी है।	Kindle Colorsoft के मालिक शिकायत करते हैं कि ई-रीडर की स्क्रीन पर एक पीली पट्टी दिखाई देती है।	किंडल कलरसॉफ्ट के स्वामी उनकी ई-रीडर की स्क्रीन पर पीले रंग की पट्टी की शिकायत करते हैं।
Nvidia and its partners built a sophisticated system to bypass U.S. restrictions on exporting AI chips to the Middle East, Russia, and China.	न्विडिया और उसके साथी ने एक विकसित प्रणाली बनाई थी जिससे यूएस निर्यात पर प्रतिबंध लगाने को मध्य पूर्व, रूस, और चीन में एआई चिप्स निर्यात करने का रास्ता खोला गया।	Nvidia और इनके साझेदारों ने एक उन्नत प्रणाली बनाई है ताकि अमेरिका द्वारा मध्य पूर्व, रूस और चीन को AI चिप्स के निर्यात पर लगाए गए प्रतिबंधों को दरकिनार किया जा सके।	एनवीडिया और उसके साझेदारों ने अमेरिका द्वारा मध्य पूर्व, रूस और चीन को एआई चिप्स निर्यात पर प्रतिबंधों को दरकिनार करने के लिए एक जटिल प्रणाली विकसित की।
The funding, which will top up the firm’s flagship fund, will be raised primarily from institutional investors. 	इस निधि को वित्तीय संस्थागणों से प्रमुख रूप से जुटाया जाएगा जो कंपनी के प्रमुख निधि को बढ़ावा देगा।	फर्म के प्रमुख फंड को बढ़ाने वाली यह धनराशि मुख्य रूप से संस्थागत निवेशकों से जुटाई जाएगी।	वित्तपोषण, जो कंपनी के प्रमुख निधि को ऊपर करेगा, संस्थागत निवेशकों से मुख्य रूप से जुटाया जाएगा।
US Forest Service Decision to Halt Prescribed Burns in California is History Repeating	हमारे अधिकारियों का कहना है कि कैलिफोर्निया में परागित जलावशेष रोकने का निर्णय इतिहास को दोहराने के समान है।	अमेरिका के वन सेवा का कैलिफोर्निया में नियंत्रित जलाने पर रोक लगाने का निर्णय इतिहास को दोहराता है।	अमेरिकी वन सेवा के कैलिफोर्निया में निर्धारित अग्नि-दहन को रोकने का निर्णय इतिहास की पुनरावृत्ति है।
The man who gave us the solution to the Entscheidungsproblem	हमें Entscheidungsproblem का समाधान देने वाले व्यक्ति।	हमें एंटशाइडुंग्सप्रॉब्लम का समाधान देने वाले व्यक्ति।	वे पुरुष जिन्होंने हमें Entscheidungsproblem का समाधान दिया
The shift in policy, covering government agencies and contractors working on national security, is intended to promote “responsible and ethical” innovations, the company said.	"हमारी कंपनी ने कहा कि नीति में हुई परिवर्तन का उद्देश्य ""जिम्मेदार और नैतिक"" नवाचारों को बढ़ावा देना है, जो कि राष्ट्रीय सुरक्षा पर काम कर रही सरकारी एजेंसियों और ठेकेदारों को कवर करती है।"	"नीति में परिवर्तन, जो सरकारी एजेंसियों और राष्ट्रीय सुरक्षा पर काम करने वाले ठेकेदारों को कवर करता है, ""जिम्मेदार और नैतिक"" नवाचारों को बढ़ावा देने के लिए किया गया है, कंपनी ने कहा।"	"नीति में परिवर्तन, राष्ट्रीय सुरक्षा पर काम करने वाली सरकारी एजेंसियों और ठेकेदारों को कवर करता है, वे ""जिम्मेदार और नैतिक"" नवाचारों को प्रोत्साहित करने के लिए है, कंपनी ने कहा।"
China reveals a new heavy lift rocket that is a clone of SpaceX’s Starship	चीन ने एक नया हेवी लिफ्ट रॉकेट खोला है जो SpaceX के स्टारशिप की क्लोन है।	चीन ने एक नया भारी लिफ्ट रॉकेट प्रस्तुत किया है जो स्पेसएक्स के स्टारशिप की नकल है।	चीन ने स्पेसएक्स के स्टारशिप की प्रतिकृति एक नया भारी लिफ्ट रॉकेट प्रस्तुत किया है।
Singapore requires vehicle owners to bid for a set number of Certificates of Entitlement – costly operating permits valid for only ten years.	सिंगापुर में वाहन मालिकों को उनके लिए एक निर्धारित संख्या की प्रमाणपत्र के लिए बोली लगानी होती है - केवल दस साल के लिए मान्य श्रम परमिट्स।	सिंगापुर में वाहन मालिकों को एक तय संख्या में प्रमाणपत्रों की बोली लगानी होती है – ये महंगे संचालन परमिट केवल दस वर्षों के लिए मान्य होते हैं।	सिंगापुर उनके वाहन स्वामियों से एक निश्चित संख्या में प्रतिभूति प्रमाणपत्र के लिए बोली लगाने की आवश्यकता है - दस वर्ष के लिए वैध महंगे संचालन अनुज्ञप्ति।
The Hwasong-19 is North Korea’s biggest missile yet and its test comes during a time of notable tensions on the peninsula.	ह्वासोंग-19 उत्तर कोरिया का सबसे बड़ा मिसाइल है और इसका परीक्षण प्रायद्वीप पर महत्वपूर्ण तनाव के समय में हो रहा है।	ह्वासॉन्ग-19 उत्तर कोरिया की अब तक की सबसे बड़ी मिसाइल है और इसका परीक्षण प्रायद्वीप पर उल्लेखनीय तनाव के समय में हुआ है।	ह्वासोंग-19 उत्तर कोरिया की अब तक की सबसे बड़ी मिसाइल है और इनका परीक्षण पेनिन्सुला पर उल्लेखनीय तनाव के समय में होता है।
The species may have been carried to the Sacramento–San Joaquin Delta in ballast water on ships	यह प्रजाति संभावित रूप से जहाजों पर बैलास्ट जल में सैक्रामेंटो-सैन जोआकिन डेल्टा तक ले जाई गई हो सकती है।	यह संभव है कि प्रजातियाँ जहाजों के बैलास्ट पानी में सैक्रामेंटो-सैन जोआक्विन डेल्टा तक लाई गई हों।	जातियाँ शिप्स के बैलेस्ट वाटर में उनके द्वारा सैक्रामेंटो-सैन जोक्विन डेल्टा में ले जाई गई होंगी।
Discovery partnered with PR firm Relevance International to produce ultra-luxury experiences and products under the banner of fictionaire billionaire Bruce Wayne’s conglomerate.	डिस्कवरी ने पीआर फर्म रिलीवेन्स इंटरनेशनल के साथ साझेदारी की ताकि उल्ट्रा-लक्जरी अनुभव और उत्पाद बनाए जा सकें, जो फिक्शनेयर बिल्यनेयर ब्रूस वेन के संगठन के बैनर के तहत हों।	डिस्कवरी ने पीआर फर्म रिलेवेंस इंटरनेशनल के साथ साझेदारी की ताकि कथा-धनी ब्रूस वेन के समूह के तहत अल्ट्रा-लक्ज़री अनुभव और उत्पाद तैयार किए जा सकें।	डिस्कवरी ने पीआर फर्म रिलेवेंस इंटरनेशनल के साथ मिलकर फिक्शनेयर अरबपति ब्रूस वेन के कॉन्ग्लोमेरेट के बैनर तले अल्ट्रा-लक्जरी अनुभव और उत्पाद प्रस्तुत किए।
Water utilities and chemical manufacturers are challenging the new EPA standards. 	जल सर्विस संगठन और रासायनिक निर्माता नए EPA मानकों का समर्थन कर रहे हैं।	जल आपूर्ति सेवाएँ और रासायनिक निर्माता नई ईपीए मानकों को चुनौती दे रहे हैं।	जल उपयोगिताएं और रासायनिक निर्मातागण नए ईपीए मानकों को चुनौती दे रहे हैं।
A radio station in Poland fired its on-air talent and brought in A.I.-generated presenters. An outcry over a purported chat with a Nobel laureate quickly ended that experiment.	पोलैंड में एक रेडियो स्टेशन ने अपने ऑन-एयर प्रतिभा को निकाल दिया और ए.आई.-निर्मित प्रस्तुतकर्ताओं को लाया। एक दावा के साथ होने वाली एक चैट के ऊपर एक चिल्लाहट जल्दी ही उस प्रयोग को समाप्त कर दिया।	पोलैंड के एक रेडियो स्टेशन ने अपने ऑन-एयर टैलेंट को हटा दिया और ए.आई.-जनित प्रस्तुतकर्ताओं को लाया। एक नोबेल पुरस्कार विजेता के साथ कथित बातचीत को लेकर हुए विरोध ने उस प्रयोग को जल्दी ही समाप्त कर दिया।	पोलैंड में एक रेडियो स्टेशन ने अपने ऑन-एयर प्रतिभाओं को निकाल दिया और एआई-जनरेटेड प्रस्तुतकर्ताओं को ले आया। नोबेल पुरस्कार विजेताओं से कथित बातचीत पर हंगामा जल्द ही उस प्रयोग को समाप्त कर दिया।
From infancy, children show heightened interest in events that are impossible or improbable, relative to likely events.	बचपन से, बच्चे उन घटनाओं में अधिक रुचि दिखाते हैं जो असंभाव या असंभाव हैं, तुलनात्मक रूप से संभावित घटनाओं के समान।	बाल्यकाल से ही, बच्चे असंभव या असंभाव्य घटनाओं की तुलना में संभावित घटनाओं में अधिक रुचि दिखाते हैं।	बचपन से, वे बच्चे उन घटनाओं में अधिक रुचि दिखाते हैं जो असंभव या असंभावना हैं, संभावित घटनाओं की तुलना में।
Four persons were referred to hospital and the rest were treated as outpatients at the event venue, police sources said.	चार व्यक्ति अस्पताल भेजे गए थे और बाकी के बारे में आउटपेशेंट के रूप में इलाज किया गया था, पुलिस स्रोतों ने बताया।	चार व्यक्तियों को अस्पताल भेजा गया और बाकी का इवेंट स्थल पर बाह्य रोगियों के रूप में इलाज किया गया, पुलिस सूत्रों ने कहा।	चार व्यक्तियों को अस्पताल में भेजा गया और शेष का इलाज आयोजन स्थल पर ओपीडी के रूप में किया गया, पुलिस सूत्रों ने कहा।
During investigation, the Washermenpet police found that he was attacked by three persons with stones and beer bottles while he was consuming alcohol.	जांच के दौरान, वॉशरमेनपेट पुलिस ने पाया कि उसे तीन व्यक्तियों ने पत्थरों और बीयर बोतलों से हमला किया गया था जब वह शराब पी रहा था।	जांच के दौरान, वाशरमेनपेट पुलिस ने पाया कि उन पर तीन व्यक्तियों ने पत्थरों और बीयर की बोतलों से हमला किया, जबकि वे शराब का सेवन कर रहे थे।	जांच के दौरान, वाशरमेनपेट पुलिस ने पाया कि उन पर तीन व्यक्तियों द्वारा पत्थरों और बीयर की बोतलों से हमला किया गया था जब वे शराब का सेवन कर रहे थे।
Two juvenile boys who were lodged at the Government Observation Home in Chengalpattu escaped on Tuesday night.	चेंगलपट्टू में सरकारी अवलोकन गृह में निवास कर रहे दो किशोर लड़के मंगलवार रात को भाग गए।	चेंगलपट्टू के सरकारी निरीक्षण गृह में रखे गए दो किशोर लड़के मंगलवार रात को फरार हो गए।	दो नाबालिग लड़के जिनको चेंगलपट्टु स्थित सरकारी अवलोकन गृह में रखा गया था, उनके मंगलवार रात को फरार हो गए।
During Mr. Gandhi’s Srinagar stay, men disembarked from cars on Boulevard road to hug him.	गांधी जी के श्रीनगर रहने के दौरान, पुलिस अधिकारी ने बुलेवार्ड रोड से कार से उतरकर उन्हें गले लगाने आए।	श्री गांधी के श्रीनगर प्रवास के दौरान, पुरुष बुलेवार्ड रोड पर गाड़ियों से उतरकर उन्हें गले लगाने के लिए आए।	श्री गांधी जी के श्रीनगर प्रवास के दौरान, बुलेवार्ड रोड पर कारों से उतरे पुरुषों ने उन्हें गले लगाया।
They alleged that several brick kilns started selling old stocks of bricks from Wednesday after paying the first instalment of the fine levied on them by the Geology and Mining Department.	उन्होंने दावा किया कि कई ईंट भट्ठियां उन्हें जो जीविका और खनन विभाग द्वारा उन पर लगाई गई जुर्माने की पहली किश्त का भुगतान करने के बाद बुधवार से पुरानी स्टॉक की ईंटें बेचना शुरू कर दिया।	उन्होंने आरोप लगाया कि कई ईंट भट्टों ने बुधवार से पुरानी ईंटों का स्टॉक बेचना शुरू कर दिया, जब उन्होंने भूविज्ञान और खनन विभाग द्वारा लगाए गए जुर्माने की पहली किस्त का भुगतान कर दिया।	वे आरोप लगाते हैं कि वे बुधवार से पुराने ईंट भंडार की बिक्री शुरू कर दी है, जिसके बाद उन पर जियोलॉजी और माइनिंग विभाग द्वारा लगाया गया जुर्माने की पहली किस्त अदा की गई है।
Ten Indian career diplomats, who are High Commissioners or Ambassadors of India in other countries, called on Governor R.N. Ravi at the Raj Bhavan in Chennai on Monday.	दस भारतीय करियर डिप्लोमेट्स, जो कि अन्य देशों में भारत के उच्च आयुक्त या राजदूत हैं, सोमवार को राज भवन में चेन्नई के गवर्नर आर.एन. रवि से मिलने आए।	दस भारतीय पेशेवर राजनयिक, जो अन्य देशों में भारत के उच्चायुक्त या राजदूत हैं, ने सोमवार को चेन्नई में राजभवन में राज्यपाल आर.एन. रवि से मुलाकात की।	दस भारतीय करियर राजनयिक, जो अन्य देशों में भारत के उच्चायुक्त या राजदूत हैं, ने सोमवार को चेन्नई में राज भवन में राज्यपाल श्री आर.एन. रवि से मुलाकात की।
However, Dr. Hande, who wrote the foreword for her book and took part in some of these Assembly debates, says Muthu discharged her duty efficiently as a Minister with no room for corruption.	हालांकि, डॉ. हांडे, जिन्होंने उसकी पुस्तक के लिए प्रस्तावना लिखी और इन सभी विधानसभा बहसों में हिस्सा लिया, कहते हैं कि मुथु ने कोई भ्रष्टाचार के लिए कोई जगह न छोड़ते हुए मंत्री के रूप में अपने कर्तव्य को कुशलतापूर्वक निभाया।	हालांकि, डॉ. हांडे, जिन्होंने उनकी पुस्तक के लिए प्रस्तावना लिखी और इन विधानसभा चर्चाओं में भाग लिया, कहते हैं कि मुथु ने मंत्री के रूप में अपनी जिम्मेदारी कुशलतापूर्वक निभाई और भ्रष्टाचार की कोई गुंजाइश नहीं छोड़ी।	वहीं, डॉक्टर हंडे जिन्होंने उनकी पुस्तक के लिए फॉरवर्ड लिखा और इन विधानसभा बहसों में भाग लिया, कहते हैं कि मuthu ने एक मंत्री के रूप में अपना कर्तव्य कुशलतापूर्वक निभाया जिसमें भ्रष्टाचार के लिए कोई स्थान नहीं था।
While both Mr. Lobo and Mr. Kamat have cited disaffection with the Congress high command as reasons, the true reasons are all too transparent.	जबकि श्री लोबो और श्री कामत ने दोनों कांग्रेस के उच्च कमांड के साथ असंतुष्टि को कारण बताया है, असली कारण सभी के लिए पर्दाफाश हैं।	श्री लोबो और श्री कामत दोनों ने कांग्रेस के उच्च नेतृत्व से असंतोष को कारण बताया है, लेकिन वास्तविक कारण स्पष्ट हैं।	जबकि श्री लोबो और श्री कामत ने कांग्रेस उच्च कमान के साथ असंतोष को कारणों के रूप में उद्धृत किया है, सच्चे कारण सभी बहुत स्पष्ट हैं।
The first festival celebrating the linguistic and cultural ties between the Barak Valley region of Assam and the Sylhet segment of Bangladesh began on Friday evening.	असम के बारक घाट क्षेत्र और बांग्लादेश के सिलहेट सेगमेंट के बीच भाषाई और सांस्कृतिक रिश्तों का पहला त्योहार शुक्रवार शाम को शुरू हुआ।	असम के बराक घाटी क्षेत्र और बांग्लादेश के सिलहट खंड के बीच भाषाई और सांस्कृतिक संबंधों का जश्न मनाने वाला पहला महोत्सव शुक्रवार शाम को शुरू हुआ।	पहला त्योहार जिसके द्वारा असम के बराक वैली क्षेत्र और बांग्लादेश के सिलहट सेगमेंट के बीच भाषाई और सांस्कृतिक संबंधों का जश्न मनाया जा रहा है, शुक्रवार शाम से आरंभ हुआ।
The objective of such markets is to incentivise investments in renewable energy sources.	"ऐसे बाजारों का उद्देश्य नवीन ऊर्जा स्रोतों में निवेश को प्रोत्साहित करना है।

Respectful translation:
ऐसे बाजारों का उद्देश्य नवीन ऊर्जा स्रोतों में निवेश को प्रोत्साहित करने का है।"	ऐसे बाजारों का उद्देश्य नवीकरणीय ऊर्जा स्रोतों में निवेश को प्रोत्साहित करना है।	उन बाज़ारों का उद्देश्य नवीकरणीय ऊर्जा स्रोतों में निवेश को प्रोत्साहित करना है।
The Centre is expected to clarify, later this year, the specifics of a carbon trading market in India.	केंद्र इस साल के अंत में भारत में एक कार्बन ट्रेडिंग बाजार की विशेषताएं स्पष्ट करने की उम्मीद है।	इस वर्ष के अंत में, केंद्र से अपेक्षा की जाती है कि वे भारत में कार्बन ट्रेडिंग बाजार के विशेष विवरण को स्पष्ट करेंगे।	केंद्र को इस साल बाद में भारत में कार्बन ट्रेडिंग बाज़ार के विशिष्ट विवरण की स्पष्टीकरण की उम्मीद है.
Hydrogen is an essential industrial fuel that has a range of uses from producing ammonia.	हाइड्रोजन एक अत्यधिक महत्वपूर्ण औद्योगिक ईंधन है जिसका उपयोग अमोनिया उत्पादन से संभावित उपयोगों की एक श्रृंखला है।	हाइड्रोजन एक आवश्यक औद्योगिक ईंधन है जिसका उपयोग अमोनिया के उत्पादन सहित विभिन्न कार्यों के लिए किया जाता है।	हाइड्रोजन एक आवश्यक औद्योगिक ईंधन हैं जिनके प्रयोग अमोनिया उत्पादन से लेकर विविध हैं।
Finance Minister Nirmala Sitharaman on Saturday said that regulators would do their job.	वित्त मंत्री निर्मला सीतारमण ने शनिवार को कहा कि नियामक सब अपना काम करेंगे।	वित्त मंत्री निर्मला सीतारमण ने शनिवार को कहा कि नियामक अपना काम करेंगे।	वित्त मंत्री निर्मला सीतारमण ने शनिवार को कहा कि नियामक उनका काम करेंगे।
Madras has received a grant of ₹242 crore to do research on laboratory-grown diamonds.	मद्रास को प्रयोगशाला में उत्पन्न हीरे पर अनुसंधान करने के लिए 242 करोड़ रुपये का अनुदान प्राप्त हुआ है।	मद्रास को प्रयोगशाला में विकसित हीरों पर शोध करने के लिए ₹242 करोड़ की अनुदान राशि प्राप्त हुई है।	मद्रास को प्रयोगशाला-विकसित हीरों पर शोध करने के लिए २४२ करोड़ रुपये का अनुदान प्राप्त हुआ है।
Before Rao took leave after the meeting, MGR gently reminded him of the Cauvery water.	राव ने बैठक के बाद छुट्टी लेने से पहले, एमजीआर ने उन्हें कावेरी जल की धीमी याद दिलाई।	बैठक के बाद जब राव विदा लेने वाले थे, तब एमजीआर ने उन्हें कोमलता से कावेरी जल की याद दिलाई।	राव जी ने बैठक के बाद छुट्टी लेने से पहले, एमजीआर ने उन्हें कावेरी जल की याद दिला दी।
It is because of this initiative that Tamil Nadu became the centre of higher learning.	इस पहल के कारण ही तमिलनाडु उच्च शिक्षा का केंद्र बन गया।	इसी पहल के कारण तमिलनाडु उच्च शिक्षा का केंद्र बन गया।	इसके प्रयास के कारण तमिलनाडु उच्च शिक्षा के केंद्र बन गए।
However, within minutes after the then Prime Minister intervened.	फिर भी, उसके बाद कुछ मिनटों के भीतर तब के प्रधानमंत्रियों ने हस्तक्षेप किया।	हालांकि, उस समय के प्रधान मंत्री के हस्तक्षेप करने के कुछ ही मिनटों के भीतर।	परंतु, तब के प्रधानमंत्री महोदयों ने हस्तक्षेप किए जाने के कुछ ही मिनटों के भीतर।
The initial shock following the Taliban’s seizure of power in Kabul is waning.	हामी पुलिस अधिकारियों को काबुल में तालिबान की शक्ति द्वारा कब्जे के पहले झटके कम हो रहे हैं।	काबुल में तालिबान के सत्ता पर कब्ज़े के बाद की प्रारंभिक आघात कम हो रही है।	प्रथम स्तब्धता काबुल में तालिबान की सत्ता हस्तांतरण के बाद कम हो रही है।
The greatest impact of denial of rights for women in the workforce would be a sharp contraction in the economy.	महिलाओं के अधिकारों की इनकार का सबसे बड़ा प्रभाव अर्थव्यवस्था में तेज़ ढीला होना होगा।	महिलाओं के कार्यबल में अधिकारों के अभाव का सबसे बड़ा प्रभाव अर्थव्यवस्था में तीव्र संकुचन होगा।	महिलाओं के कार्यबल में अधिकारों से इनकार का सबसे बड़ा प्रभाव अर्थव्यवस्था में तीव्र संकुचन होगा।
The Taliban do not shy from leveraging the issue to gain international attention.	टालिबान अंतरराष्ट्रीय ध्यान प्राप्त करने के लिए मुद्दे का लाभ उठाने से हिचकिचाहट नहीं करते।	तालिबान इस मुद्दे का उपयोग अंतरराष्ट्रीय ध्यान आकर्षित करने के लिए करने से नहीं हिचकिचाते हैं।	तालिबान वे अंतरराष्ट्रीय ध्यान आकर्षित करने के लिए इस मुद्दे का लाभ उठाने से नहीं हिचकिचाते।
In Jammu and Kashmir, the enrolment dropped sharply from 1.78 lakh in 2019-20 to 1.31 lakh in 2020-21.	जम्मू और कश्मीर में, नामांकन 2019-20 में 1.78 लाख से 2020-21 में 1.31 लाख में तेजी से गिर गया।	जम्मू और कश्मीर में, नामांकन 2019-20 में 1.78 लाख से घटकर 2020-21 में 1.31 लाख हो गया।	जम्मू और कश्मीर में, उनकी नामांकन 2019-20 में 1.78 लाख से 2020-21 में 1.31 लाख तक तेजी से गिर गया।
Senior advocate Meenakshi Arora made the oral mentioning for early hearing.	वरिष्ठ वकील मीनाक्षी अरोड़ा ने शीघ्र सुनवाई के लिए मौखिक स्मरण दिया।	वरिष्ठ अधिवक्ता मीनाक्षी अरोड़ा ने शीघ्र सुनवाई के लिए मौखिक उल्लेख किया।	महान वकील मीनाक्षी अरोरा जी ने शीघ्र सुनवाई के लिए मौखिक उल्लेख किया।
The State had never forced students out of State schools by restricting hijab.	राज्य ने कभी भी हिजाब की प्रतिबंधित करके राज्य स्कूलों से छात्रों को बाहर नहीं किया था।	राज्य ने कभी भी राज्य विद्यालयों से छात्रों को हिजाब पर प्रतिबंध लगाकर बाहर नहीं निकाला था।	राज्य ने कभी हिजाब को प्रतिबंधित करके राज्य के स्कूलों से विद्यार्थियों को बाहर नहीं निकाला था।
The patient has the right to refuse to participate in such research projects.	रोगी को ऐसे अनुसंधान परियोजनाओं में भाग लेने से इनकार करने का अधिकार है।	रोगियों के पास ऐसे अनुसंधान परियोजनाओं में भाग लेने से इंकार करने का अधिकार है।	रोगियों को ऐसे शोध परियोजनाओं में भाग लेने से इनकार करने का अधिकार है।
The field officials should remember it while implementing projects. 	क्षेत्रीय अधिकारी इसे परियोजनाएं कार्रवाई करते समय याद रखना चाहिए।	क्षेत्रीय अधिकारियों को परियोजनाओं को लागू करते समय इसे याद रखना चाहिए।	क्षेत्र अधिकारी इस बात को परियोजनाओं को लागू करते समय याद रखें।
Senior officials in the Ministry of Tribal Affairs said a change in the structure had already been approved.	जनवर्य मंत्रालय के वरिष्ठ अधिकारियों ने बताया कि संरचना में परिवर्तन को पहले ही मंजूरी दे दी गई थी।	जनजातीय मामलों के मंत्रालय के वरिष्ठ अधिकारियों ने कहा कि संरचना में बदलाव पहले ही स्वीकृत किया जा चुका है।	महालेखापाल, आदिम जाति मंत्रालय में उनके अनुसार, संरचना में परिवर्तन को पहले ही स्वीकृति दे दी गई है.
The Bhagwan Mahaveer Foundation has called for applications for the Mahaveer awards.	भगवान महावीर फाउंडेशन ने महावीर पुरस्कार के लिए आवेदन आमंत्रित किया है।	भगवान महावीर फाउंडेशन ने महावीर पुरस्कारों के लिए आवेदन आमंत्रित किए हैं।	भागवान महावीर फाउंडेशन ने महावीर पुरस्कारों के लिए आवेदन आमंत्रित किए हैं।
Mr. Yediyurappa resigned as Chief Minister and was succeeded by Basavaraj Bommai in 2020.	श्री येदियुरप्पा ने २०२० में मुख्यमंत्री के पद से इस्तीफा देकर उनके स्थान पर बासवराज बोम्मई की नियुक्ति हुई।	श्री येदियुरप्पा ने मुख्यमंत्री के रूप में इस्तीफा दे दिया और 2020 में उनकी जगह बसवराज बोम्मई ने ले ली।	श्री येदियुरप्पा जी ने मुख्यमंत्री पद से इस्तीफा दे दिया और 2020 में उनके स्थान पर बसवराज बोम्मई जी ने पदभार संभाला।
The rescuers had to cut the roof of the lift to bring them out, and nobody was hurt.	उन्हें बाहर लाने के लिए बचावकर्ताओं को लिफ्ट की छत काटनी पड़ी, और किसी को चोट नहीं आई।	"The rescuers had to cut the roof of the lift to bring them out, and nobody was hurt.

उद्धारकर्ताओं को उन्हें बाहर निकालने के लिए लिफ्ट की छत काटनी पड़ी, और कोई भी घायल नहीं हुआ।"	बचाव दल ने लिफ्ट की छत काटनी पड़ी ताकि उन्हें बाहर निकाला जा सके, और किसी को चोट नहीं आई।
The group claimed another police station attack in Rask that killed one officer on January 10.	समूह ने 10 जनवरी को रास्क में एक पुलिस थाने पर हमला किया जिसमें एक ऑफिसर की मौत हो गई।	समूह ने यह दावा किया कि रस्क में 10 जनवरी को एक और पुलिस थाने पर हुए हमले में एक अधिकारी की मृत्यु हो गई।	उन्होंने रास्क में जनवरी 10 को एक अधिकारी की मौत के साथ एक और पुलिस स्टेशन हमले का दावा किया।
Based on the complaint, an FIR has been registered against Constable Shailendra Singh and three other policemen.	शिकायत के आधार पर, थानेदार शैलेंद्र सिंह और तीन अन्य पुलिसवालों के खिलाफ एफआईआर दर्ज किया गया है।	शिकायत के आधार पर कांस्टेबल शैलेन्द्र सिंह और तीन अन्य पुलिसकर्मियों के खिलाफ एक प्राथमिकी दर्ज की गई है।	शिकायत के आधार पर, कॉन्स्टेबल शैलेंद्र सिंह और तीन अन्य पुलिस अधिकारियों के विरुद्ध एक प्राथमिकी दर्ज की गई है।
Financial institutions also play a crucial role in tracking the money trails sustaining these networks.	वित्तीय संस्थान भी इन नेटवर्क्स को संभालने वाली धन की पथों का पता लगाने में महत्वपूर्ण भूमिका निभाते हैं।	वित्तीय संस्थाएँ भी इन नेटवर्कों को बनाए रखने वाले धन के प्रवाह का पता लगाने में महत्वपूर्ण भूमिका निभाती हैं।	वित्तीय संस्थानों की भी इन नेटवर्क्स का धन प्रवाह ट्रैक करने में महत्वपूर्ण भूमिका होती है।
It is laudable that customs duties have been waived on three anti-cancer drugs.	यह प्रशंसनीय है कि तीन एंटी-कैंसर दवाओं पर सीमा शुल्क माफ किए गए हैं।	यह सराहनीय है कि तीन कैंसर-रोधी दवाओं पर सीमा शुल्क माफ कर दिए गए हैं।	यह प्रशंसनीय है कि तीन एंटी-कैंसर दवाओं पर सीमा शुल्क माफ कर दिए गए हैं।
Inside the final sprint in the biggest battleground state on the map.	माननीय पुलिस अधिकारियों, सबसे बड़े युद्धभूमि राज्य के अंतिम स्प्रिंट के अंदर।	नक्शे पर सबसे बड़े युद्धक्षेत्र राज्य में अंतिम दौड़ के अंदर।	अंतिम स्प्रिंट के अंदर सबसे बड़े युद्धक्षेत्र राज्य के मानचित्र पर।
All eyes are on America as an uncertain world awaits election result.	सभी नजरें अमेरिका पर हैं जब एक अनिश्चित दुनिया चुनाव परिणाम की प्रतीक्षा कर रही है।	सभी की निगाहें अमेरिका पर लगी हैं क्योंकि एक अनिश्चित दुनिया चुनाव परिणाम की प्रतीक्षा कर रही है।	अमेरिका पर सभी की नज़रें हैं क्योंकि अनिश्चित दुनिया चुनाव परिणाम की प्रतीक्षा कर रही हैं।
Twitch faces criticism over Israel-Gaza war content on platform.	हमें प्लेटफ़ॉर्म पर इजराइल-गाज़ा युद्ध सामग्री पर आलोचना हो रही है।	Twitch को अपने मंच पर इज़राइल-गाज़ा युद्ध की सामग्री को लेकर आलोचना का सामना करना पड़ रहा है।	ट्विच को मंच पर इस्राइल-गाजा युद्ध सामग्री के लिए आलोचना का सामना करना पड़ता है।
North Korea fires multiple ballistic missiles toward the sea ahead of U.S. election.	उत्तर कोरिया ने संयुक्त राज्य चुनाव के पहले समुद्र की ओर कई बॉलिस्टिक मिसाइल चलाए।	उत्तर कोरिया ने अमेरिका के चुनाव से पहले समुद्र की ओर कई बैलिस्टिक मिसाइलें दागी हैं।	उत्तर कोरिया ने अमेरिकी चुनाव से पहले समुद्र की ओर कई बैलिस्टिक मिसाइलें दागीं।
Singapore Airlines will add first class, revamp cabins for longest flights.	सिंगापुर एयरलाइंस ने सबसे लंबी उड़ानों के लिए पहली क्लास जोड़ने और केबिन को नया रूप देने का निश्चय किया है।	सिंगापुर एयरलाइंस अपने सबसे लंबे उड़ानों के लिए प्रथम श्रेणी जोड़ेंगी और केबिनों का नवीनीकरण करेंगी।	सिंगापुर एयरलाइन्स पहली श्रेणी जोड़ेंगे और लंबी उड़ानों के लिए केबिनों का पुनर्निर्माण करेंगे।
Priyanka Chopra Jonas and Nick Jonas celebrate 'Diwaloween,' Diwali and Halloween mashup.	प्रियंका चोपड़ा जोनस और निक जोनस 'दिवालोवीन' मनाते हैं, दिवाली और हैलोवीन का मिश्रण।	प्रियंका चोपड़ा जोनस और निक जोनस 'दिवालोवीन,' दीवाली और हैलोवीन के मिश्रण का उत्सव मनाते हैं।	प्रियंका चोपड़ा जोनस और निक जोनस 'डिवालोवीन' मनाते हैं, दिवाली और हैलोवीन का मिश्रण।
Pennsylvania officials denounce Halloween float appearing to depict Harris tied to golf cart.	पेन्सिल्वेनिया के अधिकारियों ने हैलोवीन फ्लोट की निंदा की, जिसमें हैरिस को गोल्फ कार्ट से बांधा गया दिखाई दिया।	पेंसिल्वेनिया के अधिकारी उस हैलोवीन फ्लोट की निंदा करते हैं जो ऐसा प्रतीत होता है कि हेरिस को गोल्फ कार्ट से बांधा गया है।	पेंसिल्वेनिया के अधिकारीगण हैरिस को गोल्फ कार्ट से बंधा हुआ दिखाने वाले हैलोवीन फ्लोट की निंदा करते हैं।
Elon Musk's election-doubting posts shared 9 times more than his less extreme election content.	एलन मस्क के चुनाव संदेह जताने वाले पोस्ट को उनके कम उत्तेजक चुनाव सामग्री से 9 गुना अधिक शेयर किया गया।	एलन मस्क की चुनाव-संदेह वाली पोस्टें उनकी कम उग्र चुनाव सामग्री की तुलना में 9 गुना अधिक बार साझा की गईं।	एलोन मस्क के चुनाव-संदेह वाले पोस्ट उनके कम अतिवादी चुनाव सामग्री से 9 गुना अधिक साझा किए गए।
Americans eye the economy from kitchen tables and hourly jobs as they plan their votes.	अमेरिकन लोग अपने वोट की योजना बनाते समय रसोई के मेज पर और घंटेवार नौकरियों से अर्थव्यवस्था को ध्यान से देख रहे हैं।	अमेरिकी लोग रसोई की मेजों और प्रति घंटा नौकरियों से अर्थव्यवस्था को देखते हैं जब वे अपने वोट की योजना बनाते हैं।	अमेरिकी अपने मतदान की योजना बनाते हुए रसोई की मेज़ों से और प्रति घंटा नौकरियों से अर्थव्यवस्था को देख रहे हैं।
Quincy Jones, musical maestro and entertainment industry titan, dies at 91.	क्विंसी जोन्स, संगीत महानायक और मनोरंजन उद्योग के महाशक्ति, 91 वर्ष की आयु में निधन हो जाते हैं।	क्विंसी जोन्स, संगीत के माएस्ट्रो और मनोरंजन उद्योग के दिग्गज, 91 वर्ष की आयु में निधन कर गए।	क्विंसी जोन्स, संगीत के महारथी और मनोरंजन उद्योग के दिग्गज, 91 पर उनकी देहांत हो गई।
Proud Boys claim they'll be at polling places as Trump ups violent rhetoric and fraud claims	गर्वित लड़के दावा करते हैं कि वे मतदान स्थानों पर होंगे जबकि ट्रंप हिंसक भाषण और धोखाधड़ी के दावे बढ़ाते हैं।	Proud Boys दावा करते हैं कि वे मतदान स्थलों पर मौजूद रहेंगे, जबकि ट्रम्प हिंसक बयानबाज़ी और धोखाधड़ी के दावों को बढ़ावा दे रहे हैं।	प्राउड बॉयज़ दावा करते हैं कि वे मतदान स्थलों पर होंगे क्योंकि ट्रंप हिंसक भाषण और धोखाधड़ी के दावे बढ़ाते हैं।
One of the police officers stumbled to the ground when the driver applied brakes and attempted to strike him.	गाड़ी चालक ने ब्रेक लगाया और उसको मारने की कोशिश की जब एक पुलिस अधिकारी में से एक भूमि पर गिर गया।	पुलिस अधिकारियों में से एक ज़मीन पर गिर पड़ी जब चालक ने अचानक ब्रेक लगाई और उन्हें मारने का प्रयास किया।	पुलिस अधिकारियों में से एक जमीन पर गिर पड़े जब ड्राइवर ने ब्रेक लगाया और उन्हें मारने की कोशिश की।
The authorities confirmed they have identified the vehicle's owner and expect to make an arrest shortly.	प्राधिकरणों ने पुष्टि की है कि उन्होंने वाहन के मालिक की पहचान की है और शीघ्र ही गिरफ्तारी करने की उम्मीद है।	प्राधिकारियों ने पुष्टि की है कि उन्होंने वाहन के मालिक की पहचान कर ली है और वे शीघ्र ही गिरफ्तारी की उम्मीद कर रहे हैं।	अधिकारीगण ने पुष्टि की है कि वे वाहन के मालिक की पहचान कर चुके हैं और शीघ्र ही गिरफ्तारी की उम्मीद है.
The Chhatrapati Shivaji statue in the Arabian Sea off the Mumbai coast is referred to as a precedent for the proposed pen memorial.	मुंबई के किनारे अरब सागर में स्थित छत्रपति शिवाजी की मूर्ति को प्रस्तावित कलम स्मारक के लिए एक प्रमाण के रूप में संदर्भित किया जाता है।	मुंबई के तट से दूर अरब सागर में स्थित छत्रपति शिवाजी की प्रतिमा को प्रस्तावित पेन स्मारक के लिए एक उदाहरण के रूप में संदर्भित किया जाता है।	चhatrapati Shivaji की अरब सागर में मुम्बई तट से दूर स्थित प्रतिमा प्रस्तावित कलम स्मारक के लिए एक पूर्वाधिकार के रूप में उल्लेख की जाती है.
Several political parties have opposed the pen memorial in the proposed location.	कई राजनीतिक पार्टियों ने प्रस्तावित स्थान पर कलम स्मारक का विरोध किया है।	कई राजनीतिक दलों ने प्रस्तावित स्थान पर पेन स्मारक का विरोध किया है।	अनेक राजनैतिक दलों ने प्रस्तावित स्थान पर कलम स्मारक का विरोध किया है।
They have not taken into consideration the rainfall data of 2015 or years thereafter. 	उन्होंने 2015 की वर्षाकाल के डेटा या उसके बाद के वर्षों को ध्यान में नहीं रखा है।	उन्होंने 2015 या उसके बाद के वर्षों के वर्षा डेटा पर विचार नहीं किया है।	उन्होंने 2015 या उसके बाद के वर्षों के वर्षा डेटा को विचार में नहीं लिया है।
The museum has been equipped with multimedia content, QR codes and holograms.	संग्रहालय को मल्टीमीडिया सामग्री, क्यूआर कोड और होलोग्राम के साथ सुसज्जित किया गया है।	संग्रहालय को मल्टीमीडिया सामग्री, QR कोड और होलोग्राम से सुसज्जित किया गया है।	संग्रहालय को मल्टीमीडिया सामग्री, क्यूआर कोड और होलोग्राम से सुसज्जित किया गया है।
The ninth phase of the excavations would begin later this month, said officials.	अधिकारी ने कहा कि उत्खनन की नौवीं चरण इस महीने के बाद शुरू होगा।	अधिकारियों ने कहा कि खुदाई का नौवां चरण इस महीने के अंत में शुरू होगा।	नinth चरण की खुदाई का काम इस महीने के बाद शुरू होगा, अधिकारियों ने कहा।
Mr. Reddy is a close relative of Taraka Ratna's wife Alekya Reddy.	रेड्डी साहब तारका रत्ना की पत्नी अलेख्या रेड्डी के निकट संबंधी हैं।	श्री रेड्डी, तारक रत्न की पत्नी अलेक्या रेड्डी के करीबी संबंधी हैं।	श्री रेड्डी टाराका रत्ना की पत्नी अलेक्या रेड्डी के निकट संबंधी हैं।
This betrays an inexplicable hostility towards knowledge creation of all kinds. 	यह सभी प्रकार की ज्ञान सृष्टि के प्रति एक अकाठपूर्ण दुश्मनी का प्रमाण है।	यह सभी प्रकार के ज्ञान सृजन के प्रति एक अज्ञेय शत्रुता को प्रकट करता है।	यह सभी प्रकार के ज्ञान सृजन के प्रति अकल्पनीय शत्रुता को प्रकट करता है।
The second is what he calls alienation from the process of labour.	दूसरा यह है जिसे उन्होंने श्रम की प्रक्रिया से अलगवाद कहा है।	दूसरा वह है जिसे वे श्रम की प्रक्रिया से अलगाव कहते हैं।	दूसरा वह श्रम प्रक्रिया से उनकी विदेशीकरण कहते हैं।
In the process, Marx argued, workers become miserable.	इस प्रक्रिया में, मार्क्स ने दावा किया कि श्रमिक दुखी हो जाते हैं।	इस प्रक्रिया में, मार्क्स ने तर्क दिया, श्रमिक दुखी हो जाते हैं।	इस प्रक्रिया में, मार्क्स ने तर्क दिया कि श्रमिक दुखी हो जाते हैं।
He asked the people to compare the scale of development in the adjoining Assam during eight years of BJP rule.	उन्होंने लोगों से अज़माने के लिए कहा कि अटीक्ष करें जम्बू सत्रालों में विकास के मापदंड को आसाम के समीप बीजेपी की शासन के आठ सालों में।	उन्होंने लोगों से अनुरोध किया कि वे आठ वर्षों के भाजपा शासन के दौरान आस-पास के असम में विकास के पैमाने की तुलना करें।	उन्होंने लोगों से आठ साल के भाजपा शासन के दौरान सटे असम में विकास के पैमाने की तुलना करने का अनुरोध किया।
The DMK MP also said that the Budget presented by Union Finance Minister Nirmala Sitharaman had neglected sectors such as education, health and agriculture.	DMK सांसदों ने भी कहा कि केंद्रीय वित्त मंत्री निर्मला सीतारमण द्वारा पेश की गई बजट ने शिक्षा, स्वास्थ्य और कृषि जैसे क्षेत्रों को ध्यान में नहीं रखा था।	DMK के सांसदों ने यह भी कहा कि केंद्रीय वित्त मंत्री निर्मला सीतारमण द्वारा प्रस्तुत बजट ने शिक्षा, स्वास्थ्य और कृषि जैसे क्षेत्रों की अनदेखी की है।	डीएमके सांसद ने यह भी कहा कि केंद्रीय वित्त मंत्रियों ने निर्मला सीतारमण द्वारा प्रस्तुत बजट ने शिक्षा, स्वास्थ्य और कृषि जैसे क्षेत्रों की उपेक्षा की है।
The accident took place around 3 p.m. on a State highway close to Korar village.	दुर्घटना लगभग 3 बजे के आसपास घटित हुई थी एक राज्य हाईवे पर कोरर गांव के पास।	दुर्घटना दोपहर लगभग 3 बजे राज्य राजमार्ग पर कोरार गांव के पास हुई।	दुर्घटना करीब ३ बजे राज्य राजमार्ग पर कोरार गांव के निकट हुई थी।
Both the survivors are being treated at a hospital in Raipur.	दोनों संभागियों को रायपुर में एक अस्पताल में इलाज दिया जा रहा है।	रायपुर के एक अस्पताल में दोनों जीवित बचे लोगों का इलाज किया जा रहा है।	दोनों पीड़ितों का इलाज रायपुर के एक अस्पताल में किया जा रहा है।
Chief Minister Bhupesh Baghel took to Twitter to express grief over the accident.	मुख्यमंत्री भूपेश बघेल ने ट्विटर पर दुख व्यक्त करने के लिए कदम उठाया।	मुख्यमंत्री भूपेश बघेल ने ट्विटर का सहारा लेकर दुर्घटना पर शोक व्यक्त किया।	मुख्यमंत्री भूपेश बघेल ने ट्विटर पर दुर्घटना पर शोक व्यक्त किया।
The Indian Institute of Technology Madras (IIT-M) Research Park hosted a competition for children.	भारतीय प्रौद्योगिकी संस्थान मद्रास (आईआईटी-एम) रिसर्च पार्क ने बच्चों के लिए एक प्रतियोगिता आयोजित की।	भारतीय प्रौद्योगिकी संस्थान मद्रास (आईआईटी-मद्रास) अनुसंधान पार्क ने बच्चों के लिए एक प्रतियोगिता का आयोजन किया।	भारतीय प्रौद्योगिकी संस्थान मद्रास (आईआईटी-एम) अनुसंधान पार्क ने बच्चों के लिए एक प्रतियोगिता की मेजबानी की।
"External affairs minister S Jaishankar on Tuesday expressed concern over the attack on a Hindu temple in Canada, describing the incident as ""deeply concerning."	"विदेश मामले मंत्री एस जयशंकर ने मंगलवार को कनाडा में हिन्दू मंदिर पर हमले पर चिंता व्यक्त की, घटना को ""गहरी चिंता की बात"" बताते हुए।"	"विदेश मंत्री एस जयशंकर ने मंगलवार को कनाडा में एक हिंदू मंदिर पर हुए हमले पर चिंता व्यक्त की, और इस घटना को ""गंभीर रूप से चिंताजनक"" बताया।"	"विदेश मंत्री श्री जयशंकर ने मंगलवार को कनाडा में एक हिन्दू मंदिर पर हुए हमले पर चिंता व्यक्त की, इस घटना को ""गंभीर रूप से चिंताजनक"" बताया।"
Modi condemns violence after Canada temple inciden.	मोदी ने कनाडा मंदिर हमले के बाद हिंसा की निंदा की।	मोदी जी कनाडा मंदिर घटना के बाद हिंसा की निंदा करते हैं।	मोदी जी ने कनाडा मंदिर घटना के बाद हिंसा की निंदा की है।
Mr Nijjar had been a vocal supporter of the Khalistan movement and publicly campaigned for it.	निज्जर साहब खालिस्तान आंदोलन के एक उच्चारक समर्थक रहे और उसके लिए सार्वजनिक रूप से अभियान चलाया।	श्री निज्जर खालिस्तान आंदोलन के मुखर समर्थक थे और उन्होंने इसके लिए सार्वजनिक रूप से प्रचार किया था।	श्री निज्जर जी Khalistan आंदोलन के मुखर समर्थक रहे हैं और उसके लिए सार्वजनिक रूप से प्रचार करते थे।
Bangladesh steps up repayments to Adani to avoid power supply cu.	बांग्लादेश अदानी को भुगतान बढ़ाने के लिए कदम उठा रहा है ताकि वह विद्युत आपूर्ति कटौती से बच सके।	बांग्लादेश बिजली आपूर्ति में कटौती से बचने के लिए अदानी को भुगतान बढ़ा रहे हैं।	बांग्लादेश आदानी को पुनर्भुगतान बढ़ाता है ताकि बिजली आपूर्ति कटौती से बचा जा सके।
The country is already suffering from increased power shortages in rural areas.	हमारे देश के ग्रामीण क्षेत्रों में पहले से ही बढ़ती हुई बिजली की कमी का सामना है।	देश पहले से ही ग्रामीण क्षेत्रों में बढ़ती बिजली की कमी से जूझ रहा है।	देश को पहले से ही ग्रामीण क्षेत्रों में बढ़ती बिजली की कमी का सामना करना पड़ रहा है.
Officials said 44 people were on board when the driver lost control and the bus fell into a 50m-deep ditch in Marchula, located in the state’s Almora district.	अधिकारीज़ ने कहा कि जब चालक ने नियंत्रण खो दिया और बस 50 मीटर गहरे खाई में गिर गई थी, तब मार्चुला में, राज्य के अल्मोरा जिले में 44 लोग बोर्ड पर थे।	अधिकारियों ने कहा कि 44 लोग उस समय बस में सवार थे जब ड्राइवर ने नियंत्रण खो दिया और बस राज्य के अल्मोड़ा जिले में स्थित मर्चुला में 50 मीटर गहरी खाई में गिर गई।	अधिकारियों ने कहा कि मार्चुला में स्थित अल्मोड़ा जिले में 50 मीटर गहरी खाई में बस गिरने से पहले चालक ने नियंत्रण खो दिया था और उस समय बस में 44 लोग सवार थे।
Uttarakhand's Chief Minister Pushkar Singh Dhami has also announced financial assistance for the victims and their families.	उत्तराखंड के मुख्यमंत्री पुष्कर सिंह धामी ने भी पीड़ितों और उनके परिवारों के लिए वित्तीय सहायता की घोषणा की है।	उत्तराखंड के मुख्यमंत्री पुष्कर सिंह धामी जी ने पीड़ितों और उनके परिवारों के लिए आर्थिक सहायता की घोषणा भी की है।	उत्तराखंड के मुख्यमंत्री पुष्कर सिंह धामी ने भी पीड़ितों और उनके परिवारों के लिए आर्थिक सहायता की घोषणा की है.
Our scientists used it as an incentive to develop their own technology.	हमारे वैज्ञानिकों ने इसे अपनी प्रौद्योगिकी विकसित करने के लिए प्रोत्साहन के रूप में उपयोग किया।	हमारे वैज्ञानिकों ने इसे अपनी तकनीक विकसित करने के लिए एक प्रोत्साहन के रूप में उपयोग किया।	उनके वैज्ञानिकों ने इसे अपनी स्वयं की प्रौद्योगिकी विकसित करने के लिए प्रोत्साहन के रूप में इसका उपयोग किया।
Mylswamy Annadurai, chief of India’s first and second Moon missions and Mars mission, told the BBC that Isro employs far fewer people and pays lower salaries, which makes Indian projects competitive.	मायल्स्वामी अन्नादुरै, भारत की पहली और दूसरी चंद्रमा मिशन और मंगल मिशन के मुख्य, ने बीबीसी को बताया कि इसरो बहुत कम लोगों को रखता है और कम वेतन देता है, जिससे भारतीय परियोजनाएं प्रतिस्पर्धात्मक हो जाती हैं।	भारत के पहले और दूसरे चंद्र मिशन और मंगल मिशन के प्रमुख, माइलस्वामी अन्नादुरई ने बीबीसी को बताया कि इसरो कम लोगों को नियुक्त करता है और कम वेतन देता है, जिससे भारतीय परियोजनाएँ प्रतिस्पर्धात्मक बनती हैं।	मीलस्वामी अन्नादुरई, भारत के पहले और दूसरे चंद्र मिशन तथा मंगल मिशन के प्रमुख, बीबीसी को बताया कि इसरो में काफी कम लोग कार्यरत हैं और वे निम्न वेतन देते हैं, जिससे भारतीय परियोजनाएं प्रतिस्पर्धी हो जाती हैं।
Ex-district president of Bajrang Dal Gurgaon held for shooting at Gurgaon man.	बजरंग दल गुड़गाँव के पूर्व जिलाध्यक्ष को गुड़गाँव के एक व्यक्ति पर गोली चलाने के लिए गिरफ्तार किया गया।	बजरंग दल गुड़गांव के पूर्व जिला अध्यक्ष को गुड़गांव के व्यक्ति पर गोली चलाने के आरोप में गिरफ्तार किया गया है।	पूर्व जिला अध्यक्ष बजरंग दल गुरुग्राम के उनको गुरुग्राम के एक व्यक्ति पर गोली चलाने के आरोप में हिरासत में लिया गया है.
The legendary Bob Khathing led the expedition to peacefully integrate Tawang into India.	महान बॉब खाथिंग ने टावांग को भारत में शांतिपूर्वक एकीकृत करने के लिए अभियान का नेतृत्व किया।	महान बॉब खाथिंग ने तवांग को शांति से भारत में सम्मिलित करने के अभियान का नेतृत्व किया।	वे महान बоб खाथिंग ने तवांग को भारत में शांतिपूर्ण एकीकरण के लिए अभियान का नेतृत्व किया।
In 1939, after the Second World War broke out, Khathing joined the Indian Army and got an Emergency Commission as an officer.	1939 में, दूसरे विश्व युद्ध के बाद, खातिंग ने भारतीय सेना में शामिल होकर एक आपत्कालीन कमीशन प्राप्त किया जैसे एक अधिकारी।	1939 में, जब द्वितीय विश्व युद्ध छिड़ गया, तब खाथिंग भारतीय सेना में शामिल हो गए और उन्हें एक अधिकारी के रूप में एक आपातकालीन कमीशन मिला।	१९३९ में, द्वितीय विश्व युद्ध के प्रारंभ होने के बाद, खाथिंग ने भारतीय सेना में शामिल हुए और उनको एक आपातकालीन आयोग के रूप में एक अधिकारी के रूप में मिला।
At the end of the Second World War, the Emergency Commissioned officers in the Army were demobilised.	द्वितीय विश्व युद्ध के अंत में, सेना में आपातकालीन पदों पर नियुक्त अधिकारियों को सैन्य सेवा से समाप्त किया गया था।	द्वितीय विश्व युद्ध के अंत में, सेना में आपातकालीन नियुक्त अधिकारीगण हटा दिए गए थे।	द्वितीय विश्व युद्ध के अंत में, सेना में आपातकालीन आयुक्त अधिकारी महोदय उनकी सेवा से मुक्त किए गए थे।
Most of the senior cricketers were far from their best, especially against New Zealand.	अधिकांश वरिष्ठ क्रिकेटर अपने सर्वोत्तम स्तर से दूर थे, खासकर न्यूजीलैंड के खिलाफ।	अधिकांश वरिष्ठ क्रिकेटर अपने सर्वोत्तम प्रदर्शन से दूर थे, विशेष रूप से न्यूज़ीलैंड के खिलाफ।	अधिकांश वरिष्ठ क्रिकेटर उनके सर्वश्रेष्ठ से काफी दूर थे, विशेषकर न्यूजीलैंड के विरुद्ध।
