src	gpt_3_5_trans	gpt_4o_trans	ollama_trans
JMM says Soren's helicopter take off delayed over PM's security protocol, writes to President Murmu	जेएमएम बताती है कि सोरेन का हेलीकॉप्टर पीएम की सुरक्षा प्रोटोकॉल के कारण देरी से उड़ान भरेगा, राष्ट्रपति मुर्मू को पत्र लिखती है।	JMM कहता है कि सोरेन के हेलीकॉप्टर का टेक ऑफ प्रधानमंत्री की सुरक्षा प्रोटोकॉल के कारण देरी से हुआ, राष्ट्रपति मुर्मु को पत्र लिखा।	जेएमएम का कहना है कि प्रधानमंत्री की सुरक्षा प्रोटोकॉल के कारण सोरेन के हेलीकॉप्टर के उड़ान में देरी हुई, राष्ट्रपति मुर्मू को पत्र लिखते हैं।
The king who defied the British: Uncovering the tale of Pazhassi raja’s rebellion	जो ब्रिटिश के खिलाफ उत्तराधिकारी थे: पाझसी राजा के विद्रोह की कहानी खोजना	ब्रिटिशों को चुनौती देने वाले राजा: पज़्हस्सी राजा के विद्रोह की कहानी का अनावरण	वे राजा जिन्होंने ब्रिटिश की चुनौती दी: पज़हस्सी राजा के विद्रोह की कहानी का अनावरण
Vinesh Phogat's retirement U-turn predicted after her latest Instagram post creates buzz on social media	विनेश फोगाट की रिटायरमेंट यू-टर्न की पूर्वानुमानित हो रही है उसके नवीनतम इंस्टाग्राम पोस्ट के चलते, जिससे सोशल मीडिया पर चर्चा हो रही है।	विनेश फोगाट के नवीनतम इंस्टाग्राम पोस्ट के बाद उनके संन्यास के फैसले पर पुनर्विचार की संभावना है, जिससे सोशल मीडिया पर चर्चा हो रही है।	विनेश फोगाट के सेवानिवृत्ति के यू-टर्न की भविष्यवाणी उनके नवीनतम इंस्टाग्राम पोस्ट द्वारा सोशल मीडिया पर हलचल पैदा होने के बाद की गई है.
The Pennsylvania push: Kamala Harris, Donald Trump spend final campaign hours in swing state	पेन्सिलवेनिया पुश: कमला हैरिस, डोनाल्ड ट्रम्प चुनावी घंटों का आखिरी विज्ञापन राज्य में बिताते हैं।	पेंसिल्वेनिया की कोशिश: कमला हैरिस, डोनाल्ड ट्रंप स्विंग राज्य में अंतिम प्रचार के घंटे बिताते हैं।	पेंसिल्वेनिया पुश: कमला हैरिस, डोनाल्ड ट्रंप उनके अंतिम प्रचार घंटे स्विंग स्टेट में व्यतीत कर रहे हैं।
Delhi engulfed in smog, toxic foam in Yamuna: Pics that capture national capital's pollution woes	दिल्ली धुंध में लिपटी, यमुना में विषैला फोम: तस्वीरें जो राष्ट्रीय राजधानी के प्रदूषण समस्याओं को कैप्चर करती हैं।	दिल्ली धुएं में डूबी, यमुना में विषैला झाग: राष्ट्रीय राजधानी की प्रदूषण समस्याओं को दर्शाती तस्वीरें।	दिल्ली में स्मॉग ने घेर लिया, यमुना में जहरीला फोम: राष्ट्रीय राजधानी की प्रदूषण समस्याओं को कैप्चर करने वाली तस्वीरें
Will Muslim boycott of Kamala send Trump to the White House?	क्या मुस्लिम कमाला के बहिष्कार से ट्रंप को सफेद घर भेजेगा?	क्या मुसलमानों का कमला का बहिष्कार ट्रम्प को व्हाइट हाउस भेजेगा?	क्या कामाला के मुस्लिम बहिष्कार ट्रंप को व्हाइट हाउस भेज देंगे?
Why Indian batters are struggling against left-arm spin	भारतीय बल्लेबाज वाम हाथ के स्पिनर्स के खिलाफ संघर्ष क्यों कर रहे हैं?	भारतीय बल्लेबाज बाएं हाथ के स्पिन के खिलाफ संघर्ष क्यों कर रहे हैं?	भारतीय बल्लेबाज़ लेफ्ट-आर्म स्पिन के विरुद्ध संघर्ष क्यों कर रहे हैं?
JD Vance calls Kamala Harris 'trash' at Atlanta rally: 'In 2 days we're taking out the garbage'	JD वैंस अटलांटा रैली में कमला हैरिस को 'कूड़ा' कहते हैं: '2 दिन में हम कूड़ा बाहर निकाल रहे हैं।'	JD वेंस ने अटलांटा रैली में कमला हैरिस को 'कचरा' कहा: '2 दिनों में हम कचरे को बाहर निकाल रहे हैं।'	जेडी वांस उनकी (कमला हैरिस) को 'कचरा' कहते हैं: '2 दिन में हम कचरे को हटा देंगे'
Meghan and Harry feel life in US hasn't been what they expected: Ex-staff	मेघन और हैरी को लगता है कि अमेरिका में जीवन उनकी उम्मीदों के अनुसार नहीं बीता है: पूर्व कर्मचारी।	मेघन और हैरी को लगता है कि अमेरिका में जीवन वैसा नहीं रहा जैसा उन्होंने उम्मीद की थी: पूर्व कर्मचारी	मेगन और हैरी का मानना है कि अमेरिका में जीवन उनकी उम्मीदों के अनुरूप नहीं रहा है: पूर्व-स्टाफ।
Elon Musk reacts to reports that he could be deported for immigration violation	अधिकारियों ने अलोन मस्क के प्रति प्रतिक्रिया दी है कि उन्हें प्रवासन उल्लंघन के लिए विदेश भेज दिया जा सकता है।	एलन मस्क ने उन रिपोर्टों पर प्रतिक्रिया दी है कि उन्हें आव्रजन उल्लंघन के लिए निर्वासित किया जा सकता है।	एलोन मस्क ने आव्रजन उल्लंघन के लिए उनकी निर्वासन की खबरों पर प्रतिक्रिया व्यक्त की।
How China is lessening its reliance on helium sourced from US	कैसे चीन अपनी हीलियम की आवश्यकता को कम कर रहा है, जो संयुक्त राज्य से आता है।	चीन किस प्रकार से अमेरिका से प्राप्त हीलियम पर अपनी निर्भरता कम कर रहे हैं।	चीन अमेरिका से स्रोत हीलियम पर अपनी निर्भरता कम कर रहे हैं।
Kindle Colorsoft owners complain of a yellow bar on the e-reader’s screen	Kindle Colorsoft owners का शिकायत है कि ई-रीडर की स्क्रीन पर पीला बार है।	Kindle Colorsoft के मालिक ई-रीडर की स्क्रीन पर पीली पट्टी की शिकायत करते हैं।	किंडल कलरसॉफ्ट के स्वामी उनकी ई-रीडर की स्क्रीन पर पीले रंग की पट्टी की शिकायत करते हैं।
Nvidia and its partners built a sophisticated system to bypass U.S. restrictions on exporting AI chips to the Middle East, Russia, and China.	नवीडिया और उसके साथी ने एक परिष्कृत प्रणाली बनाई थी जिससे वे मध्य पूर्व, रूस, और चीन को AI चिप्स निर्यात करने पर संयुक्त राज्य अमेरिका की प्रतिबंधों को उमकसर कर सकें।	Nvidia और उनके साझेदारों ने एक परिष्कृत प्रणाली बनाई है ताकि वे मध्य पूर्व, रूस और चीन को AI चिप्स के निर्यात पर अमेरिकी प्रतिबंधों को दरकिनार कर सकें।	एनवीडिया और उसके साझेदारों ने अमेरिका द्वारा मध्य पूर्व, रूस और चीन को एआई चिप्स निर्यात पर प्रतिबंधों को दरकिनार करने के लिए एक जटिल प्रणाली विकसित की।
The funding, which will top up the firm’s flagship fund, will be raised primarily from institutional investors. 	यह वित्तपोषण, जिससे कंपनी के प्रमुख निधि में अतिशय किया जाएगा, मुख्य रूप से संस्थागत निवेशकों से उठाया जाएगा।	प्रमुख फंड को बढ़ावा देने वाली यह निधि मुख्य रूप से संस्थागत निवेशकों से जुटाई जाएगी।	वित्तपोषण, जो कंपनी के प्रमुख निधि को ऊपर करेगा, संस्थागत निवेशकों से मुख्य रूप से जुटाया जाएगा।
US Forest Service Decision to Halt Prescribed Burns in California is History Repeating	हमारे वन सेवा ने कैलिफोर्निया में निर्धारित जलाए जाने वाले धारों को रोकने का निर्णय लेना इतिहास की दोहराव है।	अमेरिका के वन सेवा का कैलिफोर्निया में निर्धारित अग्निशमन को रोकने का निर्णय इतिहास दोहराने जैसा है।	अमेरिकी वन सेवा के कैलिफोर्निया में निर्धारित अग्नि-दहन को रोकने का निर्णय इतिहास की पुनरावृत्ति है।
The man who gave us the solution to the Entscheidungsproblem	हमें Entscheidungsproblem का समाधान देने वाले व्यक्ति।	वे सज्जन जिन्होंने हमें एंटशाइडुंग्सप्रॉब्लेम का समाधान दिया।	वे पुरुष जिन्होंने हमें Entscheidungsproblem का समाधान दिया
The shift in policy, covering government agencies and contractors working on national security, is intended to promote “responsible and ethical” innovations, the company said.	यह नीति में परिवर्तन, सरकारी एजेंसियों और राष्ट्रीय सुरक्षा पर काम करने वाले ठेकेदारों को समाहित करने के लिए है, कंपनी ने कहा।	"नीति में परिवर्तन, जो राष्ट्रीय सुरक्षा पर काम कर रही सरकारी एजेंसियों और ठेकेदारों को शामिल करता है, ""जिम्मेदार और नैतिक"" नवाचारों को प्रोत्साहित करने के उद्देश्य से है, कंपनी ने कहा।"	"नीति में परिवर्तन, राष्ट्रीय सुरक्षा पर काम करने वाली सरकारी एजेंसियों और ठेकेदारों को कवर करता है, वे ""जिम्मेदार और नैतिक"" नवाचारों को प्रोत्साहित करने के लिए है, कंपनी ने कहा।"
China reveals a new heavy lift rocket that is a clone of SpaceX’s Starship	चीन ने एक नए हैवी लिफ्ट रॉकेट का पर्दाफाश किया है जो SpaceX के स्टारशिप की एक क्लोन है।	चीन ने एक नया भारी-भरकम रॉकेट प्रस्तुत किया है, जो स्पेसएक्स के स्टारशिप का क्लोन है।	चीन ने स्पेसएक्स के स्टारशिप की प्रतिकृति एक नया भारी लिफ्ट रॉकेट प्रस्तुत किया है।
Singapore requires vehicle owners to bid for a set number of Certificates of Entitlement – costly operating permits valid for only ten years.	सिंगापुर में वाहन मालिकों को एक सेट संबंधित स्वीकृति प्रमाण पत्रों के लिए बोली लगाने की आवश्यकता है - केवल दस साल के लिए मान्य उचित अनुमतियां।	सिंगापुर में वाहन मालिकों को सीमित संख्या में प्रमाणपत्रों (Certificates of Entitlement) के लिए बोली लगानी पड़ती है, जो केवल दस वर्षों के लिए मान्य महंगे संचालन परमिट होते हैं।	सिंगापुर उनके वाहन स्वामियों से एक निर्धारित संख्या में प्राधिकरण प्रमाणपत्रों के लिए बोली लगाने की आवश्यकता है - दस वर्ष के लिए वैध महंगे संचालन अनुज्ञप्तियाँ।
The Hwasong-19 is North Korea’s biggest missile yet and its test comes during a time of notable tensions on the peninsula.	ह्वासोंग-19 उत्तर कोरिया का सबसे बड़ा मिसाइल है और इसका परीक्षण प्रायद्वीप पर विशेष तनाव के समय में हुआ है।	Hwasong-19 उत्तर कोरिया की अब तक की सबसे बड़ी मिसाइल है और इसका परीक्षण प्रायद्वीप पर उल्लेखनीय तनाव के समय में हुआ है।	ह्वासोंग-19 उत्तर कोरिया की अब तक की सबसे बड़ी मिसाइल है और इनका परीक्षण पेनिनसुला पर उल्लेखनीय तनाव के समय में होता है।
The species may have been carried to the Sacramento–San Joaquin Delta in ballast water on ships	इस प्रजाति को संयुक्त राजधानी-सैक्रामेंटो-सैन जोक्विन डेल्टा में जहाजों पर बॉलास्ट जल में ले जाया गया हो सकता है।	प्रजातियों को जहाजों पर बैलास्ट पानी में सैक्रामेंटो-सैन जोआक्विन डेल्टा तक ले जाया गया हो सकता है।	जातियाँ शिप्स के बैलेस्ट वाटर में उनके द्वारा सैक्रामेंटो-सैन जोक्विन डेल्टा में ले जाई गई होंगी।
Discovery partnered with PR firm Relevance International to produce ultra-luxury experiences and products under the banner of fictionaire billionaire Bruce Wayne’s conglomerate.	हमने खोज किसी भी रिलेवेंस इंटरनेशनल के साथ साझेदारी की ताकि हम फिक्शनेयर बिलियनेयर ब्रूस वेन के संगठन के तहत अल्ट्रा-लक्जरी अनुभव और उत्पाद उत्पन्न कर सकें।	डिस्कवरी ने PR फर्म रिलेवेंस इंटरनेशनल के साथ साझेदारी की है ताकि फिक्शनायर बिलियनेयर ब्रूस वेन के समूह के तहत अल्ट्रा-लक्जरी अनुभवों और उत्पादों का निर्माण किया जा सके।	डिस्कवरी ने रीलेवंस इंटरनेशनल नामक पीआर फर्म के साथ मिलकर फिक्शनेयर अरबपति ब्रूस वेन के कॉन्ग्लोमेरेट के बैनर तले अति-विलासित अनुभव और उत्पाद प्रस्तुत किए।
Water utilities and chemical manufacturers are challenging the new EPA standards. 	जल सेवाएं और रासायनिक उत्पादक नए ईपीए मानकों का समर्थन कर रहे हैं।	जल उपयोगिताएँ और रासायनिक निर्माता नई ईपीए मानकों को चुनौती दे रहे हैं।	जल उपयोगिताएं और रासायनिक निर्मातागण नए ईपीए मानकों को चुनौती दे रहे हैं।
A radio station in Poland fired its on-air talent and brought in A.I.-generated presenters. An outcry over a purported chat with a Nobel laureate quickly ended that experiment.	पोलैंड में एक रेडियो स्टेशन ने अपने ऑन-एयर प्रतिभाओं को निकाल दिया और ए.आई.-जेनरेटेड प्रस्तुतकर्ता लाए। एक नोबेल पुरस्कार विजेता के साथ किए गए दावे पर उत्तरदाताओं की उग्र आवाज़ ने उस प्रयोग को तुरंत खत्म कर दिया।	पोलैंड के एक रेडियो स्टेशन ने अपने ऑन-एयर प्रतिभा को हटा दिया और ए.आई.-जनित प्रस्तुतकर्ताओं को लेकर आया। एक नोबेल पुरस्कार विजेता के साथ कथित बातचीत को लेकर हुए विरोध ने उस प्रयोग को जल्दी समाप्त कर दिया।	पोलैंड में एक रेडियो स्टेशन ने अपने ऑन-एयर प्रतिभाओं को निकाल दिया और एआई-जनरेटेड प्रस्तुतकर्ताओं को ले आया। एक नोबेल पुरस्कार विजेता के साथ कथित चैट पर हंगामा जल्द ही उस प्रयोग को समाप्त कर दिया।
From infancy, children show heightened interest in events that are impossible or improbable, relative to likely events.	बचपन से, बच्चे उन घटनाओं में अधिक रुचि दिखाते हैं जो असंभाव या असंभाव हैं, साकार घटनाओं के संबंध में।	बचपन से ही बच्चे उन घटनाओं में अधिक रुचि दिखाते हैं जो असंभव या असंभाव्य होती हैं, अपेक्षाकृत उन घटनाओं के जो संभव होती हैं।	बचपन से, वे बच्चे उन घटनाओं में अधिक रुचि दिखाते हैं जो असंभव या असंभावना हैं, संभावित घटनाओं की तुलना में।
Four persons were referred to hospital and the rest were treated as outpatients at the event venue, police sources said.	चार व्यक्तियों को अस्पताल भेजा गया था और बाकी को इवेंट स्थल पर बाह्य रोगी के रूप में उपचार किया गया था, पुलिस स्रोतों ने बताया।	चार व्यक्तियों को अस्पताल भेजा गया और शेष का इलाज कार्यक्रम स्थल पर बाह्य रोगियों के रूप में किया गया, पुलिस सूत्रों ने कहा।	चार व्यक्तियों को अस्पताल में भेजा गया और शेष का इलाज आयोजन स्थल पर आउटपेशेंट के रूप में किया गया, पुलिस सूत्रों ने कहा।
During investigation, the Washermenpet police found that he was attacked by three persons with stones and beer bottles while he was consuming alcohol.	जांच के दौरान, वाशर्मेनपेट पुलिस ने पाया कि उसे तीन व्यक्तियों ने पत्थरों और बीयर बोतलों से हमला किया गया था जब वह शराब पी रहा था।	जांच के दौरान, वाशरमेनपेट पुलिस ने पाया कि उन पर तीन व्यक्तियों ने पत्थरों और बीयर की बोतलों से हमला किया था, जब वह शराब का सेवन कर रहे थे।	जांच के दौरान, वाशरमेनपेट पुलिस ने पाया कि उन पर तीन व्यक्तियों ने पत्थरों और बीयर की बोतलों से हमला किया था जब वे शराब का सेवन कर रहे थे।
Two juvenile boys who were lodged at the Government Observation Home in Chengalpattu escaped on Tuesday night.	चेंगलपट्टू में सरकारी अवलोकन होम में रखे गए दो नाबालिग लड़के मंगलवार रात को भाग गए।	चेंगलपट्टू में सरकारी निरीक्षण गृह में रखे गए दो किशोर लड़के मंगलवार रात को फरार हो गए।	दो नाबालिग लड़के जिनको चेंगलपट्टु स्थित सरकारी अवलोकन गृह में रखा गया था, उनके मंगलवार रात को फरार हो गए।
During Mr. Gandhi’s Srinagar stay, men disembarked from cars on Boulevard road to hug him.	गांधी जी के श्रीनगर में रहने के दौरान, लोग बुलेवार्ड रोड से उतरकर उन्हें गले लगाने आए।	श्री गांधी की श्रीनगर यात्रा के दौरान, लोग बुलेवार्ड रोड पर कारों से उतरकर उन्हें गले लगाने के लिए आए।	श्री गांधी जी के श्रीनगर प्रवास के दौरान, बुलेवार्ड रोड पर गाड़ियों से उतरे पुरुषों ने उन्हें आलिंगन किया।
They alleged that several brick kilns started selling old stocks of bricks from Wednesday after paying the first instalment of the fine levied on them by the Geology and Mining Department.	Unhone dawa kiya ki kai eent kilno ne Budhvar se purane bricks ki stok bechne shuru kar diye, jab unhone Geology aur Mining Vibhag dawara unpar laga dand ke pehle kist ko bhugatne ke baad shuru kiya.	उन्होंने आरोप लगाया कि कई ईंट भट्टों ने बुधवार से अपने पुराने स्टॉक की ईंटें बेचना शुरू कर दिया है, जब उन्होंने भूविज्ञान और खनन विभाग द्वारा उन पर लगाए गए जुर्माने की पहली किस्त का भुगतान कर दिया।	उन्होंने आरोप लगाया कि वे कई ईंट भट्ठे बुधवार से पुराने ईंट स्टॉक की बिक्री शुरू कर दी थी, जिसके बाद उन पर भूविज्ञान और खनन विभाग द्वारा लगाया गया जुर्माने की पहली किस्त का भुगतान किया था।
Ten Indian career diplomats, who are High Commissioners or Ambassadors of India in other countries, called on Governor R.N. Ravi at the Raj Bhavan in Chennai on Monday.	दस भारतीय करियर दूत, जो कि अन्य देशों में भारत के उच्चायुक्त या राजदूत हैं, सोमवार को चेन्नई के राज भवन में गवर्नर आर.एन. रवि से मिलने आए।	दस भारतीय करियर राजनयिक, जो अन्य देशों में भारत के उच्चायुक्त या राजदूत हैं, ने सोमवार को चेन्नई के राज भवन में राज्यपाल आर.एन. रवि से मुलाकात की।	दस भारतीय करियर राजनयिक, जो अन्य देशों में भारत के उच्चायुक्त या राजदूत हैं, ने सोमवार को चेन्नई में राज भवन में राज्यपाल श्री आर.एन. रवि से मुलाकात की।
However, Dr. Hande, who wrote the foreword for her book and took part in some of these Assembly debates, says Muthu discharged her duty efficiently as a Minister with no room for corruption.	हालांकि, डॉ. हांडे, जिन्होंने उसकी पुस्तक के लिए प्रारंभिक वक्तव्य लिखा और इन सभी सभा बहसों में भाग लिया, कहते हैं कि मुथू ने कोई भ्रष्टाचार के लिए कोई जगह न देते हुए एक मंत्री के रूप में अपनी दायित्व निष्पादित की।	हालाँकि, डॉ. हांडे, जिन्होंने उनकी पुस्तक के लिए भूमिका लिखी और इन विधानसभा चर्चाओं में से कुछ में भाग लिया, कहते हैं कि मुथु ने एक मंत्री के रूप में अपना कर्तव्य कुशलतापूर्वक निभाया और भ्रष्टाचार की कोई गुंजाइश नहीं छोड़ी।	वैसे, डॉक्टर हंडे जिन्होंने उनकी पुस्तक के लिए फॉरवर्ड लिखा और इन विधानसभा बहसों में भाग लिया, कहते हैं कि मुत्तु ने एक मंत्री के रूप में अपना कर्तव्य कुशलता से निभाया जिसमें भ्रष्टाचार के लिए कोई स्थान नहीं था।
While both Mr. Lobo and Mr. Kamat have cited disaffection with the Congress high command as reasons, the true reasons are all too transparent.	जबकि श्री लोबो और श्री कामत ने दोनों कांग्रेस की उच्च कमान के साथ असंतोष को कारण बताया है, सच्चे कारण सबके लिए पर्दाफाश हैं।	श्री लोबो और श्री कामत, दोनों ने कांग्रेस उच्च नेतृत्व के प्रति असंतोष को कारण बताया है, लेकिन वास्तविक कारण बहुत ही स्पष्ट हैं।	जबकि श्री लोबो और श्री कामत ने कांग्रेस उच्च कमान के साथ असंतोष को कारणों के रूप में उद्धृत किया है, सच्चे कारण सभी के लिए स्पष्ट हैं.
The first festival celebrating the linguistic and cultural ties between the Barak Valley region of Assam and the Sylhet segment of Bangladesh began on Friday evening.	असम के बरक घाटी क्षेत्र और बांग्लादेश के सिलहेट सेगमेंट के बीच भाषाई और सांस्कृतिक संबंधों का पहला त्योहार शुक्रवार शाम से शुरू हुआ।	असम के बराक घाटी क्षेत्र और बांग्लादेश के सिलहट खंड के बीच भाषाई और सांस्कृतिक संबंधों का उत्सव मनाने वाला पहला महोत्सव शुक्रवार शाम को शुरू हुआ।	पहला त्योहार जिसने असम के बराक वैली क्षेत्र और बांग्लादेश के सिलहट सेगमेंट के बीच भाषाई और सांस्कृतिक संबंधों का जश्न मनाया, शुक्रवार शाम को आरंभ हुआ।
The objective of such markets is to incentivise investments in renewable energy sources.	ऐसे बाजारों का उद्देश्य नवीनीकरण ऊर्जा स्रोतों में निवेश करने को प्रोत्साहित करना है।	ऐसे बाजारों का उद्देश्य नवीकरणीय ऊर्जा स्रोतों में निवेश को प्रोत्साहित करना है।	उन बाज़ारों का उद्देश्य नवीकरणीय ऊर्जा स्रोतों में निवेश को प्रोत्साहित करना है।
The Centre is expected to clarify, later this year, the specifics of a carbon trading market in India.	केंद्र को इस साल के बाद में भारत में कार्बन ट्रेडिंग मार्केट के विवरण को स्पष्ट करने की उम्मीद है।	केन्द्र इस वर्ष के अंत में भारत में एक कार्बन व्यापार बाजार के विशेष विवरण को स्पष्ट करने की अपेक्षा करता है।	केंद्र को इस साल बाद में, भारत में कार्बन ट्रेडिंग बाज़ार के विशेषज्ञों की व्याख्या करने की उम्मीद है.
Hydrogen is an essential industrial fuel that has a range of uses from producing ammonia.	हाइड्रोजन एक अत्यधिक महत्वपूर्ण औद्योगिक ईंधन है जिसके कई उपयोग होते हैं, जैसे न्हारित अमोनिया उत्पन्न करना।	हाइड्रोजन एक आवश्यक औद्योगिक ईंधन है जिसका उपयोग अमोनिया के उत्पादन सहित विभिन्न कार्यों में होता है।	हाइड्रोजन एक आवश्यक औद्योगिक ईंधन हैं जिनके प्रयोग अमोनिया उत्पादन से लेकर विविध हैं।
Finance Minister Nirmala Sitharaman on Saturday said that regulators would do their job.	वित्त मंत्री निर्मला सीतारमण ने शनिवार को कहा कि नियामक संस्थान अपना कार्य करेंगे।	वित्त मंत्री निर्मला सीतारमण ने शनिवार को कहा कि नियामक अपना काम करेंगे।	वित्त मंत्री निर्मला सीतारमण ने शनिवार को कहा कि नियामक उनका काम करेंगे।
Madras has received a grant of ₹242 crore to do research on laboratory-grown diamonds.	मद्रास को प्रयोगशाला में उत्पन्न हीरे पर अनुसंधान करने के लिए 242 करोड़ रुपये का अनुदान प्राप्त हुआ है।	मद्रास को प्रयोगशाला में तैयार किए गए हीरों पर शोध करने के लिए ₹242 करोड़ का अनुदान प्राप्त हुआ है।	मद्रास को प्रयोगशाला-विकसित हीरों पर शोध करने के लिए २४२ करोड़ रुपये का अनुदान प्राप्त हुआ है।
Before Rao took leave after the meeting, MGR gently reminded him of the Cauvery water.	मीटिंग के बाद राव ने छुट्टी लेने से पहले, एमजीआर ने उन्हें कावेरी जल के बारे में धीरे से याद दिलाया।	बैठक के बाद राव के जाने से पहले, एमजीआर ने उन्हें कोमलता से कावेरी जल की याद दिलाई।	राव जी ने बैठक के बाद अवकाश लेने से पहले, एमजीआर ने उन्हें कावेरी जल की याद दिला दी।
It is because of this initiative that Tamil Nadu became the centre of higher learning.	यह पहल के कारण ही तमिलनाडु उच्च शिक्षा का केंद्र बन गया।	इसी पहल के कारण तमिलनाडु उच्च शिक्षा का केंद्र बन गया।	इसके प्रयास के कारण तमिलनाडु उच्च शिक्षा के केंद्र बन गए।
However, within minutes after the then Prime Minister intervened.	फिर भी, उस समय के प्रधानमंत्रियों ने हस्तक्षेप किया।	हालाँकि, कुछ ही मिनटों के भीतर जब तत्कालीन प्रधानमंत्री जी ने हस्तक्षेप किया।	परंतु, तब के प्रधानमंत्री महोदयों ने हस्तक्षेप किए जाने के कुछ मिनटों के भीतर।
The initial shock following the Taliban’s seizure of power in Kabul is waning.	अफगानिस्तान में तालिबान की शक्ति हासिल करने के बाद की पहली चौंक हल्की हो रही है।	काबुल में तालिबान के सत्ता पर कब्ज़ा करने के बाद का प्रारंभिक आघात कम हो रहा है।	प्रथम स्तब्धता काबुल में तालिबान की सत्ता हस्तांतरण के बाद कम हो रही हैं।
The greatest impact of denial of rights for women in the workforce would be a sharp contraction in the economy.	महिलाओं के अधिकारों की इनकार का सबसे बड़ा प्रभाव कार्यशाला में एक तेज़ संकुचन में होगा।	महिलाओं के कार्यक्षेत्र में अधिकारों के अभाव का सबसे बड़ा प्रभाव अर्थव्यवस्था में तीव्र संकुचन होगा।	महिलाओं के कार्यबल में अधिकारों से इनकार का सबसे बड़ा प्रभाव अर्थव्यवस्था में तीव्र संकुचन होगा।
The Taliban do not shy from leveraging the issue to gain international attention.	टालिबान अंतरराष्ट्रीय ध्यान प्राप्त करने के लिए मुद्दे का उपयोग करने से शर्मिंदा नहीं होते।	तालिबान अंतरराष्ट्रीय ध्यान आकर्षित करने के लिए इस मुद्दे का लाभ उठाने से नहीं हिचकिचाते हैं।	तालिबान वे अंतरराष्ट्रीय ध्यान आकर्षित करने के लिए इस मुद्दे का लाभ उठाने से नहीं हिचकिचाते।
In Jammu and Kashmir, the enrolment dropped sharply from 1.78 lakh in 2019-20 to 1.31 lakh in 2020-21.	जम्मू और कश्मीर में पंजीकरण में 2019-20 में 1.78 लाख से 2020-21 में 1.31 लाख तक तेजी से गिरावट आई।	जम्मू और कश्मीर में, नामांकन 2019-20 में 1.78 लाख से घटकर 2020-21 में 1.31 लाख रह गया।	जम्मू और कश्मीर में, उनकी नामांकन 2019-20 में 1.78 लाख से 2020-21 में 1.31 लाख तक तेजी से गिर गया।
Senior advocate Meenakshi Arora made the oral mentioning for early hearing.	वरिष्ठ वकील मीनाक्षी अरोड़ा ने जल्दी सुनवाई के लिए मौखिक उल्लेख किया।	वरिष्ठ अधिवक्ता मीनाक्षी अरोड़ा ने शीघ्र सुनवाई के लिए मौखिक उल्लेख किया।	महान वकील मीनाक्षी अरोरा जी ने शीघ्र सुनवाई के लिए मौखिक उल्लेख किया।
The State had never forced students out of State schools by restricting hijab.	राज्य ने कभी भी हिजाब की प्रतिबंधित करके राज्य स्कूलों से छात्रों को निकालने का दबाव नहीं डाला था।	राज्य ने कभी भी हिजाब पर प्रतिबंध लगाकर छात्रों को राज्य के स्कूलों से बाहर नहीं किया।	राज्य ने कभी राज्य के स्कूलों से हिजाब प्रतिबंधित करके छात्र-छात्राओं को बाहर नहीं निकाला।
The patient has the right to refuse to participate in such research projects.	रोगी को ऐसे शोध परियोजनाओं में भाग लेने से इनकार करने का अधिकार है।	रोगियों को ऐसे अनुसंधान परियोजनाओं में भाग लेने से इनकार करने का अधिकार होता है।	मरीज़ों को ऐसे शोध परियोजनाओं में भाग लेने से इनकार करने का अधिकार है।
The field officials should remember it while implementing projects. 	क्षेत्रीय अधिकारी को परियोजनाओं को कार्यान्वित करते समय इसे ध्यान में रखना चाहिए।	क्षेत्रीय अधिकारियों को यह ध्यान में रखना चाहिए जब वे परियोजनाओं को लागू कर रहे हों।	क्षेत्र अधिकारी इस बात को परियोजनाओं को लागू करते समय याद रखें।
Senior officials in the Ministry of Tribal Affairs said a change in the structure had already been approved.	जनजाति कार्य मंत्रालय के वरिष्ठ अधिकारी ने बताया कि संरचना में परिवर्तन को पहले ही मंजूरी दे दी गई थी।	जनजातीय मामलों के मंत्रालय के वरिष्ठ अधिकारियों ने कहा कि संरचना में परिवर्तन पहले ही अनुमोदित किया जा चुका है।	महालेखापाल, आदिवासी मामलों के मंत्रालय में वरिष्ठ अधिकारी कहा कि संरचना में परिवर्तन पहले से ही स्वीकृत हो चुका है.
The Bhagwan Mahaveer Foundation has called for applications for the Mahaveer awards.	भगवान महावीर फाउंडेशन ने महावीर पुरस्कार के लिए आवेदन आमंत्रित किए हैं।	भगवान महावीर फाउंडेशन ने महावीर पुरस्कारों के लिए आवेदन आमंत्रित किए हैं।	भागवान महावीर फाउंडेशन ने महावीर पुरस्कारों के लिए आवेदन आमंत्रित किए हैं।
Mr. Yediyurappa resigned as Chief Minister and was succeeded by Basavaraj Bommai in 2020.	येदियुरप्पा जी ने 2020 में मुख्यमंत्री के पद से इस्तीफा दे दिया और उनके स्थान पर बासवराज बोम्मई जी ने कार्यभार संभाला।	श्री येदियुरप्पा ने मुख्यमंत्री के रूप में इस्तीफा दे दिया और 2020 में उनकी जगह बसवराज बोम्मई ने ली।	श्री येदियुरप्पा जी ने मुख्यमंत्री पद से इस्तीफा दे दिया और 2020 में उनके स्थान पर बसवराज बोम्मई जी ने पदभार संभाला।
The rescuers had to cut the roof of the lift to bring them out, and nobody was hurt.	उद्धारकर्ताओं को उन्हें बाहर लाने के लिए लिफ्ट की छत काटनी पड़ी और किसी को चोट नहीं आई।	उद्धारकर्ताओं को उन्हें बाहर लाने के लिए लिफ्ट की छत काटनी पड़ी, और किसी को चोट नहीं आई।	बचाव दल ने लिफ्ट की छत काटनी पड़ी ताकि उन्हें बाहर निकाला जा सके, और किसी को चोट नहीं आई।
The group claimed another police station attack in Rask that killed one officer on January 10.	समूह ने 10 जनवरी को रास्क में एक पुलिस थाने के हमले का दावा किया, जिसमें एक ऑफिसर की मौत हो गई।	समूह ने 10 जनवरी को रस्क में एक और पुलिस स्टेशन पर हमले का दावा किया, जिसमें एक अधिकारी की मृत्यु हो गई।	वे रास्क में जनवरी 10 को एक अधिकारी की मौत के साथ एक और पुलिस स्टेशन हमले का दावा करते हैं।
Based on the complaint, an FIR has been registered against Constable Shailendra Singh and three other policemen.	शिकायत के आधार पर, कॉन्स्टेबल शैलेंद्र सिंह और तीन अन्य पुलिसवालों के खिलाफ एफआईआर दर्ज किया गया है।	शिकायत के आधार पर, कांस्टेबल शैलेन्द्र सिंह और तीन अन्य पुलिसकर्मियों के खिलाफ एक प्राथमिकी दर्ज की गई है।	शिकायत के आधार पर, कॉन्स्टेबल शैलेंद्र सिंह और तीन अन्य पुलिस अधिकारियों के विरुद्ध एक प्राथमिकी दर्ज की गई है।
Financial institutions also play a crucial role in tracking the money trails sustaining these networks.	वित्तीय संस्थान भी इन नेटवर्क को संभालने वाली मनी ट्रेल की पहचान में महत्वपूर्ण भूमिका निभाते हैं।	वित्तीय संस्थाएँ भी इन नेटवर्कों को बनाए रखने वाले धन मार्गों का पता लगाने में महत्वपूर्ण भूमिका निभाती हैं।	वित्तीय संस्थानों की भी इन नेटवर्क्स का धन प्रवाह ट्रैक करने में महत्वपूर्ण भूमिका होती है।
It is laudable that customs duties have been waived on three anti-cancer drugs.	यह प्रशसनीय है कि तीन एंटी-कैंसर दवाओं पर गोली दी गई वसूली का आलंब चुकाया गया है।	यह सराहनीय है कि तीन एंटी-कैंसर दवाओं पर सीमा शुल्क माफ कर दिए गए हैं।	यह प्रशंसनीय है कि तीन एंटी-कैंसर दवाओं पर सीमा शुल्क माफ कर दिए गए हैं।
Inside the final sprint in the biggest battleground state on the map.	माननीय अधिकारियों के लिए अनुरोध है कि मानवीय दृष्टिकोण से उपयुक्त भाषा का प्रयोग करें। नक्षे पर सबसे बड़े युद्धभूमि राज्य में अंतिम स्प्रिंट के अंदर।	नक्शे पर सबसे बड़े युद्धक्षेत्र राज्य में अंतिम दौड़ के अंदर।	अंतिम स्प्रिंट के अंदर सबसे बड़े युद्धक्षेत्र राज्य के मानचित्र पर।
All eyes are on America as an uncertain world awaits election result.	सभी नजरें अमेरिका पर हैं जब एक अनिश्चित दुनिया चुनाव परिणाम की प्रतीक्षा कर रही है।	अनिश्चित दुनिया चुनाव परिणाम की प्रतीक्षा कर रही है और सभी की निगाहें अमेरिका पर हैं।	अमेरिका पर सभी की नज़रें हैं क्योंकि अनिश्चित दुनिया चुनाव परिणाम की प्रतीक्षा कर रही हैं।
Twitch faces criticism over Israel-Gaza war content on platform.	ट्विच तटस्थकों के द्वारा इस्राइल-गाजा युद्ध सामग्री पर आलोचना का सामना कर रहा है।	Twitch को अपने प्लेटफ़ॉर्म पर इज़राइल-गाज़ा युद्ध सामग्री को लेकर आलोचनाओं का सामना करना पड़ रहा है।	ट्विच को इज़राइल-गाज़ा युद्ध से संबंधित प्लेटफॉर्म पर सामग्री की आलोचना का सामना करना पड़ रहा है।
North Korea fires multiple ballistic missiles toward the sea ahead of U.S. election.	उत्तर कोरिया ने संयुक्त राज्य चुनाव के पहले समुद्र की ओर कई बॉलिस्टिक मिसाइल चलाए।	उत्तरी कोरिया ने अमेरिका के चुनाव से पहले समुद्र की ओर कई बैलिस्टिक मिसाइलें दागी हैं।	उत्तर कोरिया ने अमेरिकी चुनाव से पहले समुद्र की ओर कई बैलिस्टिक मिसाइलें दागीं।
Singapore Airlines will add first class, revamp cabins for longest flights.	सिंगापुर एयरलाइनें सबसे लंबी उड़ानों के लिए पहली क्लास जोड़ेंगी, केबिन को नवीनीकरण करेंगी।	सिंगापुर एयरलाइंस प्रथम श्रेणी जोड़ेंगी, सबसे लंबी उड़ानों के लिए केबिनों को नया रूप देंगी।	सिंगापुर एयरलाइन्स प्रथम श्रेणी जोड़ेंगे और लंबी उड़ानों के लिए केबिनों का पुनर्निर्माण करेंगे।
Priyanka Chopra Jonas and Nick Jonas celebrate 'Diwaloween,' Diwali and Halloween mashup.	प्रियंका चोपड़ा जोनस और निक जोनस 'दिवालीवीन' मना रहे हैं, दीवाली और हैलोवीन का मिश्रण।	प्रियंका चोपड़ा जोनस और निक जोनस 'दिवालीवीन' का जश्न मनाते हैं, जो दिवाली और हैलोवीन का मिश्रण है।	प्रियंका चोपड़ा जोनस और निक जोनस 'डिवालोवीन' मनाते हैं, दिवाली और हैलोवीन का मिश्रण।
Pennsylvania officials denounce Halloween float appearing to depict Harris tied to golf cart.	पेन्सिल्वेनिया के अधिकारी हैलोवीन फ्लोट की निंदा करते हैं, जिसमें हैरिस को गोल्फ कार्ट से बांधा गया दिखाई दिया है।	पेंसिल्वेनिया के अधिकारी उस हैलोवीन फ्लोट की निंदा करते हैं जो हैरिस को गोल्फ कार्ट से बंधे हुए दर्शाता प्रतीत होता है।	पेंसिल्वेनिया के अधिकारीगण हैरिस को गोल्फ कार्ट से बंधा हुआ दिखाने वाले हैलोवीन फ्लोट की निंदा करते हैं।
Elon Musk's election-doubting posts shared 9 times more than his less extreme election content.	एलॉन मस्क के चुनाव संदेह जताने वाले पोस्टों को उनकी कम उत्तेजक चुनाव सामग्री से 9 गुना ज्यादा शेयर किया गया।	एलन मस्क की चुनाव पर संदेह जताने वाली पोस्टें उनके कम चरम चुनावी सामग्री की तुलना में 9 गुना अधिक साझा की गईं।	एलोन मस्क के चुनाव-संदेह वाले पोस्ट उनके कम अतिवादी चुनाव सामग्री से 9 गुना अधिक साझा किए गए।
Americans eye the economy from kitchen tables and hourly jobs as they plan their votes.	अमेरिकन लोग अपने वोट की योजना बनाते समय अपने रसोई के मेज़ और प्रति घंटे की नौकरियों से अर्थव्यवस्था पर नजर रखते हैं।	अमेरिकी अपनी रसोई की मेजों और प्रति घंटा नौकरियों से अर्थव्यवस्था पर नज़र डालते हैं जब वे अपने वोटों की योजना बनाते हैं।	अमेरिकी अपने मतदान की योजना बनाते हुए रसोई की मेज़ों से और प्रति घंटा नौकरियों से अर्थव्यवस्था को देख रहे हैं।
Quincy Jones, musical maestro and entertainment industry titan, dies at 91.	क्विंसी जोन्स, संगीत के महान संगीतकार और मनोरंजन उद्योग के ताकतवर, 91 वर्ष की आयु में निधन हो गए।	क्विंसी जोन्स, संगीत के महान गुरु और मनोरंजन उद्योग के दिग्गज, 91 वर्ष की आयु में निधन कर गए।	क्विंसी जोन्स, संगीत के महारथी और मनोरंजन उद्योग के दिग्गज, 91 पर उनकी देहांत हो गई।
Proud Boys claim they'll be at polling places as Trump ups violent rhetoric and fraud claims	गर्वित लड़के दावा करते हैं कि वे मतदान स्थलों पर होंगे जैसे ही ट्रंप हिंसक भाषण और फर्जी दावे बढ़ाता हैं।	प्राउड बॉयज़ का दावा है कि वे मतदान स्थलों पर मौजूद रहेंगे क्योंकि ट्रम्प हिंसक बयानबाजी और धोखाधड़ी के दावों को बढ़ा रहे हैं।	प्राउड बॉयज़ दावा करते हैं कि वे मतदान स्थलों पर होंगे क्योंकि ट्रंप हिंसक भाषण और धोखाधड़ी के दावे बढ़ाते हैं।
One of the police officers stumbled to the ground when the driver applied brakes and attempted to strike him.	जब ड्राइवर ने ब्रेक लगाया और उस पर हमला करने की कोशिश की, तो पुलिस अधिकारियों में से एक भूमि पर गिर गया।	पुलिस अधिकारियों में से एक ज़मीन पर गिर गए जब चालक ने ब्रेक लगाए और उन्हें मारने का प्रयास किया।	पुलिस अधिकारियों में से एक जमीन पर गिर पड़े जब ड्राइवर ने ब्रेक लगाया और उन्हें मारने की कोशिश की।
The authorities confirmed they have identified the vehicle's owner and expect to make an arrest shortly.	प्राधिकरणों ने पुष्टि की है कि उन्होंने वाहन के मालिक की पहचान की है और जल्द ही गिरफ्तारी की उम्मीद है।	प्राधिकारियों ने पुष्टि की है कि उन्होंने वाहन के मालिक की पहचान कर ली है और वे शीघ्र ही गिरफ्तारी करने की उम्मीद करते हैं।	अधिकारीगण ने पुष्टि की है कि वे वाहन के मालिक की पहचान कर चुके हैं और शीघ्र ही गिरफ्तारी की उम्मीद है।
The Chhatrapati Shivaji statue in the Arabian Sea off the Mumbai coast is referred to as a precedent for the proposed pen memorial.	मुंबई के तट पर अरब सागर में स्थित छत्रपति शिवाजी की प्रतिमा को सूझावित कलम स्मारक के लिए एक प्रथमान के रूप में संदर्भित किया जाता है।	मुंबई तट से दूर अरब सागर में स्थित छत्रपति शिवाजी की प्रतिमा को प्रस्तावित पेन स्मारक के लिए एक उदाहरण के रूप में संदर्भित किया जाता है।	चhatrapati Shivaji की प्रतिमा अरब सागर में मुम्बई तट से दूर स्थित है, जिसका उल्लेख प्रस्तावित कलम स्मारक के लिए एक पूर्वाधिकार के रूप में किया जाता है.
Several political parties have opposed the pen memorial in the proposed location.	कई राजनीतिक पार्टियों ने प्रस्तावित स्थान पर कलम स्मारक का विरोध किया है।	कई राजनीतिक दलों ने प्रस्तावित स्थान पर पेन स्मारक का विरोध किया है।	अनेक राजनैतिक दलों ने प्रस्तावित स्थान पर कलम स्मारक का विरोध किया है।
They have not taken into consideration the rainfall data of 2015 or years thereafter. 	उन्होंने 2015 की बारिश के डेटा या उसके बाद के वर्षों को ध्यान में नहीं रखा है।	उन्होंने 2015 या उसके बाद के वर्षों के वर्षा डेटा पर विचार नहीं किया है।	उन्होंने 2015 या उसके बाद के वर्षों के वर्षा डेटा को विचार में नहीं लिया है।
The museum has been equipped with multimedia content, QR codes and holograms.	म्यूज़ियम को मल्टीमीडिया सामग्री, क्यूआर कोड और होलोग्राम के साथ सुसज्जित किया गया है।	संग्रहालय को मल्टीमीडिया सामग्री, क्यूआर कोड और होलोग्राम से सुसज्जित किया गया है।	संग्रहालय को मल्टीमीडिया सामग्री, क्यूआर कोड और होलोग्राम से सुसज्जित किया गया है।
The ninth phase of the excavations would begin later this month, said officials.	अधिकारी ने बताया कि खुदाई की नौवीं चरण इस महीने के बाद शुरू होगा।	अधिकारियों ने कहा कि खुदाई के नौवें चरण की शुरुआत इस महीने के अंत में होगी।	नinth चरण की खुदाई का काम इस महीने के बाद शुरू होगा, अधिकारियों ने कहा।
Mr. Reddy is a close relative of Taraka Ratna's wife Alekya Reddy.	रेड्डी जी तारका रत्ना की पत्नी अलेक्या रेड्डी के करीबी रिश्तेदार हैं।	श्री रेड्डी, तारका रत्न की पत्नी अलेख्या रेड्डी के निकट संबंधी हैं।	श्री रेड्डी टाराका रत्न की पत्नी अलेक्या रेड्डी के निकट संबंधी हैं।
This betrays an inexplicable hostility towards knowledge creation of all kinds. 	यह सभी प्रकार के ज्ञान सृजन के प्रति अव्याख्यात्मक दुश्मनी का प्रकटीकरण करता है।	यह सभी प्रकार के ज्ञान सृजन के प्रति एक अज्ञात शत्रुता को प्रकट करता है।	यह सभी प्रकार के ज्ञान सृजन के प्रति अकल्पनीय शत्रुता को प्रकट करता है।
The second is what he calls alienation from the process of labour.	दूसरा वह है जिसे वे श्रम की प्रक्रिया से पराया कहते हैं।	दूसरा है जिसे वे श्रम की प्रक्रिया से विलगाव कहते हैं।	दूसरा वह लेबर की प्रक्रिया से विदेशीकरण की अवस्था कहते हैं।
In the process, Marx argued, workers become miserable.	मार्क्स ने यह दावा किया कि प्रक्रिया में, श्रमिक दुखी हो जाते हैं।	प्रक्रिया के दौरान, मार्क्स ने तर्क दिया, श्रमिक दुखी हो जाते हैं।	इस प्रक्रिया में, मार्क्स ने तर्क दिया कि श्रमिक दुखी हो जाते हैं।
He asked the people to compare the scale of development in the adjoining Assam during eight years of BJP rule.	उन्होंने लोगों से अटल भाजपा की शासन काल में पड़ोसी असम में विकास के माप को तुलना करने के लिए कहा।	उन्होंने लोगों से अनुरोध किया कि वे भाजपा के आठ वर्षों के शासन के दौरान आस-पास के असम में विकास के पैमाने की तुलना करें।	उन्होंने लोगों से आठ साल के भाजपा शासन के दौरान सटे असम में विकास के पैमाने की तुलना करने का अनुरोध किया।
The DMK MP also said that the Budget presented by Union Finance Minister Nirmala Sitharaman had neglected sectors such as education, health and agriculture.	DMK सांसदों ने भी कहा कि केंद्रीय वित्त मंत्री निर्मला सीतारमण द्वारा पेश किया गया बजट शिक्षा, स्वास्थ्य और कृषि जैसे क्षेत्रों को अनदेखा किया गया था।	DMK सांसद ने यह भी कहा कि केंद्रीय वित्त मंत्री निर्मला सीतारमण द्वारा प्रस्तुत बजट ने शिक्षा, स्वास्थ्य और कृषि जैसे क्षेत्रों की उपेक्षा की है।	डीएमके सांसद ने यह भी कहा कि केंद्रीय वित्त मंत्रियों ने निर्मला सीतारमण द्वारा प्रस्तुत बजट ने शिक्षा, स्वास्थ्य और कृषि जैसे क्षेत्रों की उपेक्षा की है।
The accident took place around 3 p.m. on a State highway close to Korar village.	दुर्घटना लगभग दोपहर 3 बजे कोरार गाँव के पास राज्य मार्ग पर हुई थी।	दुर्घटना दोपहर 3 बजे के करीब राज्य राजमार्ग पर कोरार गांव के पास हुई।	दुर्घटना उनके राज्य राजमार्ग पर करोर गांव के निकट 3 बजे दोपहर के आसपास हुई थी।
Both the survivors are being treated at a hospital in Raipur.	दोनों सर्वाइवर्स का इलाज रायपुर के अस्पताल में किया जा रहा है।	रायपुर के एक अस्पताल में दोनों बचे हुए व्यक्तियों का इलाज किया जा रहा है।	दोनों सर्वाइवर्स का इलाज रायपुर के एक अस्पताल में किया जा रहा है।
Chief Minister Bhupesh Baghel took to Twitter to express grief over the accident.	मुख्य मंत्रियों भूपेश बघेल ने दुर्घटना पर दुःख व्यक्त करने के लिए ट्विटर पर उतरा।	मुख्यमंत्री भूपेश बघेल ने हादसे पर शोक व्यक्त करने के लिए ट्विटर का सहारा लिया।	मुख्यमंत्री भूपेश बघेल ने ट्विटर पर दुर्घटना पर शोक व्यक्त किया।
The Indian Institute of Technology Madras (IIT-M) Research Park hosted a competition for children.	भारतीय प्रौद्योगिकी संस्थान मद्रास (आईआईटी-एम) रिसर्च पार्क ने एक मुकाबले का आयोजन किया था बच्चों के लिए।	भारतीय प्रौद्योगिकी संस्थान मद्रास (आईआईटी-एम) अनुसंधान पार्क ने बच्चों के लिए एक प्रतियोगिता का आयोजन किया।	भारतीय प्रौद्योगिकी संस्थान मद्रास (आईआईटी-एम) अनुसंधान पार्क ने बच्चों के लिए एक प्रतियोगिता की मेजबानी की।
"External affairs minister S Jaishankar on Tuesday expressed concern over the attack on a Hindu temple in Canada, describing the incident as ""deeply concerning."	"बाहरी मामले मंत्रिमंडल एस जयशंकर ने मंगलवार को कैनेडा में हिंदू मंदिर पर हमले पर चिंता व्यक्त की, इस घटना को ""गहरी चिंता का विषय"" कहते हुए।"	"विदेश मंत्री एस जयशंकर ने मंगलवार को कनाडा में एक हिंदू मंदिर पर हुए हमले पर चिंता व्यक्त की, और इस घटना को ""गहन चिंता का विषय"" करार दिया।"	"विदेश मंत्री श्री जयशंकर ने मंगलवार को कनाडा में एक हिन्दू मंदिर पर हुए हमले पर चिंता व्यक्त की, इस घटना को ""गंभीर रूप से चिंताजनक"" बताया।"
Modi condemns violence after Canada temple inciden.	मोदी ने कनाडा मंदिर हमले के बाद हिंसा की निंदा की।	मोदी जी ने कनाडा के मंदिर की घटना के बाद हिंसा की निंदा की।	मोदी जी ने कनाडा मंदिर घटना के बाद हिंसा की निंदा की है।
Mr Nijjar had been a vocal supporter of the Khalistan movement and publicly campaigned for it.	निज्जर जी खालिस्तान आंदोलन के एक जोरदार समर्थक रहे थे और उसके लिए सार्वजनिक रूप से प्रचार किया था।	श्री निज्जर खालिस्तान आंदोलन के मुखर समर्थक थे और इसके लिए सार्वजनिक रूप से अभियान चलाते थे।	श्री निज्जर जी Khalistan आंदोलन के मुखर समर्थक रहे हैं और उसके लिए सार्वजनिक रूप से प्रचार करते थे।
Bangladesh steps up repayments to Adani to avoid power supply cu.	बांग्लादेश ने विद्युत आपूर्ति कटौती से बचने के लिए आदानी को चुकाने की गति बढ़ा दी है।	बांग्लादेश बिजली आपूर्ति में कटौती से बचने के लिए अदानी को भुगतान बढ़ा रहा है।	बांग्लादेश आदानी को पुनर्भुगतान बढ़ाता है ताकि बिजली आपूर्ति कटौती से बचा जा सके।
The country is already suffering from increased power shortages in rural areas.	हमारे देश में ग्रामीण क्षेत्रों में बढ़ती हुई बिजली की कमी से पहले से ही परेशानी है।	देश पहले से ही ग्रामीण क्षेत्रों में बढ़ती बिजली की कमी से पीड़ित है।	देश को पहले से ही ग्रामीण क्षेत्रों में बढ़ती बिजली की कमी का सामना करना पड़ रहा है.
Officials said 44 people were on board when the driver lost control and the bus fell into a 50m-deep ditch in Marchula, located in the state’s Almora district.	अधिकारियों ने कहा कि मार्चुला में ड्राइवर को नियंत्रण खो दिया गया था और बस 50 मीटर गहरे खाई में गिर गई जब 44 लोग बोर्ड पर थे, जो राज्य के अल्मोड़ा जिले में स्थित है।	अधिकारियों ने कहा कि जब चालक ने नियंत्रण खो दिया और बस राज्य के अल्मोड़ा जिले में स्थित मर्चुला में 50 मीटर गहरी खाई में गिर गई, तब 44 लोग सवार थे।	अधिकारियों ने कहा कि मार्चुला में स्थित अल्मोड़ा जिले में 50 मीटर गहरी खाई में बस गिरने से पहले चालक ने नियंत्रण खो दिया था और उस समय बस में 44 लोग सवार थे।
Uttarakhand's Chief Minister Pushkar Singh Dhami has also announced financial assistance for the victims and their families.	उत्तराखंड के मुख्यमंत्री पुष्कर सिंह धामी ने भी पीड़ितों और उनके परिवारों के लिए वित्तीय सहायता की घोषणा की है।	उत्तराखंड के मुख्यमंत्री पुष्कर सिंह धामी जी ने भी पीड़ितों और उनके परिवारों के लिए वित्तीय सहायता की घोषणा की है।	उत्तराखंड के मुख्यमंत्री पुष्कर सिंह धामी ने भी पीड़ितों और उनके परिवारों के लिए आर्थिक सहायता की घोषणा की है.
Our scientists used it as an incentive to develop their own technology.	हमारे वैज्ञानिकों ने उसे अपनी प्रौद्योगिकी विकसित करने के लिए प्रेरणा के रूप में उपयोग किया।	हमारे वैज्ञानिकों ने इसे अपनी स्वयं की प्रौद्योगिकी विकसित करने के लिए एक प्रोत्साहन के रूप में उपयोग किया।	उनके वैज्ञानिकों ने इसे अपनी स्वयं की प्रौद्योगिकी विकसित करने के लिए प्रोत्साहन के रूप में इसका उपयोग किया।
Mylswamy Annadurai, chief of India’s first and second Moon missions and Mars mission, told the BBC that Isro employs far fewer people and pays lower salaries, which makes Indian projects competitive.	मायलस्वामी अन्नादुराई, भारत की पहली और दूसरी चंद्रमा मिशन और मंगल मिशन के मुख्य हैं, उन्होंने बीबीसी को बताया कि इसरो बहुत कम लोगों को अपने अंग रखता है और कम वेतन देता है, जिससे भारतीय परियोजनाएँ प्रतिस्पर्धी बनती हैं।	माइल्स्वामी अन्नादुरै, भारत के पहले और दूसरे चंद्र मिशनों और मंगल मिशन के प्रमुख, ने बीबीसी को बताया कि इसरो कम लोगों को नियुक्त करता है और कम वेतन देता है, जिससे भारतीय परियोजनाएँ प्रतिस्पर्धात्मक होती हैं।	मीलस्वामी अन्नादुरई, भारत के पहले और दूसरे चंद्र मिशन तथा मंगल मिशन के प्रमुख, बीबीसी को बताया कि इसरो में काफी कम लोग कार्यरत हैं और वे निम्न वेतन देते हैं, जिससे भारतीय परियोजनाएं प्रतिस्पर्धी हो जाती हैं।
Ex-district president of Bajrang Dal Gurgaon held for shooting at Gurgaon man.	बजरंग दल गुड़गांव के पूर्व जिलाध्यक्ष को गुड़गांव में एक आदमी पर गोली चलाने के लिए गिरफ्तार किया गया।	बजरंग दल गुरुग्राम के पूर्व जिला अध्यक्ष को गुरुग्राम के व्यक्ति पर गोली चलाने के लिए हिरासत में लिया गया है।	पूर्व जिला अध्यक्षगण बजरंग दल गुरुग्राम को गुरुग्राम के व्यक्ति पर गोली चलाने के लिए हिरासत में लिए गए हैं।
The legendary Bob Khathing led the expedition to peacefully integrate Tawang into India.	महान Bob Khathing ने उस अभियान का नेतृत्व किया जिसके माध्यम से तवांग को भारत में शांतिपूर्वक एकीकृत किया गया।	महान बॉब खाथिंग ने तवांग को शांति से भारत में सम्मिलित करने के अभियान का नेतृत्व किया।	वे महान बоб खाथिंग ने तवांग को भारत में शांतिपूर्ण एकीकरण के लिए अभियान का नेतृत्व किया।
In 1939, after the Second World War broke out, Khathing joined the Indian Army and got an Emergency Commission as an officer.	1939 में, जब द्वितीय विश्व युद्ध शुरू हुआ, उस समय खाथिंग ने भारतीय सेना में शामिल होकर एक आधिकारिक आदेश प्राप्त किया।	1939 में, जब द्वितीय विश्व युद्ध छिड़ गया, तब खथिंग भारतीय सेना में शामिल हो गए और अधिकारी के रूप में उन्हें इमरजेंसी कमीशन प्राप्त हुआ।	१९३९ में, द्वितीय विश्व युद्ध के प्रारंभ होने के बाद, खाथिंग ने भारतीय सेना में शामिल हुए और उनको एक आपातकालीन आयोग के रूप में एक अधिकारी के रूप में मिला।
At the end of the Second World War, the Emergency Commissioned officers in the Army were demobilised.	द्वितीय विश्व युद्ध के अंत में, सेना में आपातकालीन कमीशन प्राप्त अधिकारी नियन्त्रण से मुक्त किए गए थे।	द्वितीय विश्व युद्ध के अंत में, सेना में आपातकालीन नियुक्त अधिकारीगणों को सेवामुक्त कर दिया गया।	द्वितीय विश्व युद्ध के अंत में, सेना में आपातकालीन आयुक्त अधिकारी महोदयों को विसर्जित किया गया।
Most of the senior cricketers were far from their best, especially against New Zealand.	अधिकांश वरिष्ठ क्रिकेट खिलाड़ी अपने सर्वश्रेष्ठ स्तर से दूर थे, खासकर न्यूजीलैंड के खिलाफ।	अधिकांश वरिष्ठ क्रिकेटर अपनी सर्वश्रेष्ठ स्थिति से बहुत दूर थे, विशेष रूप से न्यूज़ीलैंड के खिलाफ।	अधिकांश वरिष्ठ क्रिकेटर उनके सर्वश्रेष्ठ से काफी दूर थे, विशेषकर न्यूजीलैंड के विरुद्ध।
