src	gpt_3_5_trans	gpt_4o_trans	ollama_trans
JMM says Soren's helicopter take off delayed over PM's security protocol, writes to President Murmu	JMM म्हणते की सोरेनच्या हेलिकॉप्टरची उड्डाण विलंबित झाली आहे पीएमच्या सुरक्षा नियमांच्या कारणे, राष्ट्रपती मुर्मुला लिहिते.	जेएमएम म्हणते की पंतप्रधानांच्या सुरक्षा प्रोटोकॉलमुळे सोरेन यांच्या हेलिकॉप्टरचे उड्डाण विलंबित झाले आहे, असे राष्ट्रपतींना लिहिले आहे.	जेएमएम सांगते की सोरेन यांचे हेलिकॉप्टरचे उड्डाण पंतप्रधानांच्या सुरक्षा प्रोटोकॉलमुळे विलंबित झाले, राष्ट्रपती मुर्मू यांना पत्र लिहिले.
The king who defied the British: Uncovering the tale of Pazhassi raja’s rebellion	ब्रिटिशांच्या विरुद्ध उत्तर दिलेले राजा: पझस्सी राजाच्या विद्रोहाची कहाणी उघड्णारी	ब्रिटिशांना आव्हान देणारे राजे: पझाशी राजांच्या बंडाची कथा उलगडताना	राजे ज्यांनी ब्रिटिशांना आव्हान दिले: पझास्सी राजांच्या बंडाची कथा उघड करत आहोत
Vinesh Phogat's retirement U-turn predicted after her latest Instagram post creates buzz on social media	विनेश फोगाटच्या नवीन इंस्टाग्राम पोस्टनंतर सोशल मीडियावर धमाल तयार होत असून, तिन्हीचा निवृत्ती यु-टर्न अपेक्षित आहे.	विनेश फोगाट यांच्या नवीनतम इन्स्टाग्राम पोस्टने सोशल मीडियावर चर्चेची लाट निर्माण केली असून त्यांच्या निवृत्तीबाबत त्यांनी घेतलेल्या निर्णयातून बदल होण्याची शक्यता व्यक्त केली जात आहे.	विनेश फोगाटांचा निवृत्तीचा वळण फेरफार झाल्यानंतर त्यांच्या नवीन इंस्टाग्राम पोस्टने सोशल मीडियावर खळबळ उडाली.
The Pennsylvania push: Kamala Harris, Donald Trump spend final campaign hours in swing state	पेन्सिल्व्हेनिया धक्कादायक: कमला हॅरिस, डोनाल्ड ट्रंप स्विंग राज्यातील अंतिम चुनाव तास बितीच्या क्षणींसाठी खर्च करतात.	पेनसिल्व्हेनियाची धडपड: कमला हॅरिस आणि डोनाल्ड ट्रम्प शेवटच्या प्रचाराच्या तासांमध्ये स्विंग राज्यात वेळ घालवतात.	पेन्सिल्व्हानिया पुश: कामाला हॅरिस, डोनाल्ड ट्रम्प अंतिम प्रचार तास स्विंग स्टेटमध्ये व्यतीत करतात.
Delhi engulfed in smog, toxic foam in Yamuna: Pics that capture national capital's pollution woes	दिल्ली स्मॉगमध्ये लपविलेली, यमुना नदीत विषारी कडक: राष्ट्रपतीय राजधानीच्या प्रदूषण चिंता दर्शवणारे चित्रे	दिल्ली धुक्याने वेढली गेली आहे, आणि यमुनामध्ये विषारी फेस आहे: राष्ट्रीय राजधानीच्या प्रदूषणाच्या समस्यांचे चित्रण करणारे फोटो.	दिल्ली धुम्रपानाने वेढली गेली आहे, यमुनेत विषारी फोम: राष्ट्रीय राजधानीच्या प्रदूषणाच्या वेदना टिपणाऱ्या चित्रां
Will Muslim boycott of Kamala send Trump to the White House?	कमालाचा मुस्लिम बॉयकॉट ट्रंपाला व्हाइट हाऊसमध्ये पाठवेल का?	"""कामालाच्या बहिष्कारामुळे मुस्लीमांनी ट्रम्प यांना व्हाइट हाऊसमध्ये पाठवणार का?"""	कमाला ला मुस्लिमांचा बहिष्कार ट्रंपला व्हाइट हाउसात पाठवील का?
Why Indian batters are struggling against left-arm spin	भारतीय बॅट्समन डावीकडील स्पिनर्सविरुद्ध कठिणाई सामोरे असतात का?	भारतीय फलंदाज डावखुऱ्या फिरकीविरुद्ध का संघर्ष करत आहेत?	भारतीय बॅट्समॅन लेफ्ट-आर्म स्पिन विरुद्ध का संघर्ष करत आहेत
JD Vance calls Kamala Harris 'trash' at Atlanta rally: 'In 2 days we're taking out the garbage'	जेडी व्हॅन्स अटलांटा रॅलीत कमला हॅरिसला 'कचरा' म्हणून बोलतो: '2 दिवसांत आपला कचरा निघणार आहे'	जेडी वॅन्स यांनी अटलांटा रॅलीत कमला हॅरिस यांना 'कचरा' म्हटले: 'दोन दिवसांत आम्ही कचरा बाहेर काढणार आहोत'.	जेड व्हान्स यांनी अटलांटा रॅलीमध्ये कमला हॅरिस यांना 'कचरा' म्हटले: '२ दिवसांत आम्ही कचरा काढून टाकतो'
Meghan and Harry feel life in US hasn't been what they expected: Ex-staff	मेघन आणि हॅरीला वाटतं की संयुक्त राज्यातील जीवन त्यांनी काहीही अपेक्षित केलं नाही: पूर्व कर्मचारींसाठी	मेघन आणि हॅरी यांना वाटते की अमेरिकेतील जीवन त्यांच्या अपेक्षेप्रमाणे नाही: माजी कर्मचारी	मेगन आणि हॅरी यांना अमेरिकेतील जीवन त्यांच्या अपेक्षेप्रमाणे नाही असे वाटते: माजी स्टाफ.
Elon Musk reacts to reports that he could be deported for immigration violation	एलॉन मस्कांच्या प्रतिक्रिया ज्या अहवालांनुसार त्याला प्रवास उल्लंघनासाठी निष्कासित केले जाऊ शकतो असं विचारले जात आहे.	एलोन मस्क यांनी स्थलांतर नियमांचे उल्लंघन केल्याबद्दल त्यांना हद्दपार केले जाऊ शकते या अहवालांवर प्रतिक्रिया दिल्या.	ईलोन मस्क यांना आपल्या स्थलांतर विघ्नाबद्दलच्या अहवालांना प्रतिक्रिया देतात.
How China is lessening its reliance on helium sourced from US	चीन कसं अमेरिकेतून हेलियमचं आधार कमी करीत आहे याची कसं प्रतिबद्धता करत आहे?	चीन अमेरिकेतून मिळणाऱ्या हीलियमवरील आपली अवलंबित्वता कमी कसे करत आहेत?	चीन अमेरिकेकडून मिळवलेल्या हेलियमवरील अवलंबन कमी करीत आहेत.
Kindle Colorsoft owners complain of a yellow bar on the e-reader’s screen	किंडल कलरसॉफ्ट यांच्या मालकांनी ई-रीडरच्या स्क्रीनवर एक पिवळा बार आहे अशा तक्रार केल्या आहेत.	Kindle Colorsoft चे मालक ई-रीडरच्या स्क्रीनवर पिवळ्या पट्टीची तक्रार करतात.	कलरसॉफ्ट मालकांनी ई-रीडरच्या स्क्रीनवर पिवळा बार याबद्दल तक्रार केली आहे.
Nvidia and its partners built a sophisticated system to bypass U.S. restrictions on exporting AI chips to the Middle East, Russia, and China.	न्विडिया आणि त्याचे साथी संघात एक प्रगतिशील प्रणाली तयार केली जी मध्य पूर्व, रशिया आणि चीनला AI चिप्सना निर्यात करण्याच्या यु.एस.च्या प्रतिबंधांवर स्थानांतरित करण्यासाठी तयार केली आहे.	Nvidia आणि त्यांच्या भागीदारांनी मध्यपूर्व, रशिया आणि चीनला AI चिप्स निर्यात करण्यावर असणाऱ्या अमेरिकेच्या निर्बंधांना वळसा घालण्यासाठी एक अत्याधुनिक प्रणाली तयार केली आहे.	एन्विडिया आणि त्यांचे भागीदारांनी अमेरिकेच्या निर्यातीवरील निर्बंधांना टाळून मध्यपूर्व, रशिया आणि चीनला एआय चिप्स निर्यात करण्यासाठी एक सुसूत्र प्रणाली बांधली.
The funding, which will top up the firm’s flagship fund, will be raised primarily from institutional investors. 	या निधीला, ज्याने कंपनीच्या प्रमुख निधीला वाढवणार आहे, सर्वाधिक मुद्रांधारकांकडून मुख्यत: जमा केलं जाईल.	आस्थापनाच्या मुख्य निधीला वाढविण्यासाठी आवश्यक असणारे भांडवल मुख्यत्वे संस्थात्मक गुंतवणूकदारांकडून उभारले जाईल.	ते निधी जे कंपनीच्या प्रमुख निधीस पूरक ठरतील, ते प्रामुख्याने संस्थात्मक ग्राहकांकडून उभारले जातील.
US Forest Service Decision to Halt Prescribed Burns in California is History Repeating	अमेरिकेच्या वन सेवेच्या निर्णयाने कॅलिफोर्नियातील प्रीस्क्रायब्ड बर्न्सचा थांबावा इतिहास फिरतंय असा आहे.	अमेरिकेच्या वनसेवेच्या कॅलिफोर्नियामध्ये नियोजित जाळपोळ थांबवण्याच्या निर्णयामुळे इतिहासाची पुनरावृत्ती होत आहे.	अमेरिकेच्या वन सेवा विभागाने कॅलिफोर्नियामध्ये नियोजित जाळ्या थांबविण्याचा निर्णय म्हणजे इतिहास स्वतःच पुनरावृत्त होत आहे.
The man who gave us the solution to the Entscheidungsproblem	एवढ्या समस्येचे समाधान दिलेला व्यक्ती	आम्हाला एन्शाइडुंग्सप्रॉब्लेमचा उपाय दिलेल्या व्यक्ती.	ते पुरुष ज्यांनी आम्हाला Entscheidungsproblem चे उत्तर दिले
The shift in policy, covering government agencies and contractors working on national security, is intended to promote “responsible and ethical” innovations, the company said.	"सरकारी अधिकारकर्त्यांच्या आणि राष्ट्रीय सुरक्षा वर काम करणार्‍या कंपन्यांच्या दृष्टीकोनात नीतीमध्ये झोप झाल्याने ""उत्तरसंवेदनशील आणि नैतिक"" वृद्धीसाठीचा हे तयार केलं आहे, कंपनी म्हणाली."	"नीतीतील बदल, ज्यामध्ये सरकारी संस्था आणि राष्ट्रीय सुरक्षा क्षेत्रात कार्यरत असलेले कंत्राटदार समाविष्ट आहेत, ""जबाबदार आणि नैतिक"" नवप्रवर्तनांना प्रोत्साहन देण्यासाठी उद्दिष्ट आहे, असे कंपनीने म्हटले आहे."	"कंपनीने सांगितले की, राष्ट्रीय सुरक्षेसाठी काम करणाऱ्या सरकारी संस्था आणि ठेकेदारांना व्यापते अशा धोरणातील बदलाने ""उत्तरदायी आणि नैतिक"" नवकल्पना प्रोत्साहन देण्याचे उद्दिष्ट आहे."
China reveals a new heavy lift rocket that is a clone of SpaceX’s Starship	कार्यालयाने एक नवीन मोठी भार उठवणारी रॉकेट उघडली आहे ज्याची SpaceXच्या स्टारशिपची नकल करणारी आहे.	चीनने नवीन हेवी लिफ्ट रॉकेट सादर केले आहे, जे SpaceXच्या स्टारशिपचे क्लोन आहे.	चीनाने स्पेसएक्सच्या स्टारशिपचा क्लोन असलेला नवीन भारी लिफ्ट रॉकेट उघडकीस आणला आहे.
Singapore requires vehicle owners to bid for a set number of Certificates of Entitlement – costly operating permits valid for only ten years.	सिंगापूरने वाहन मालकांना एक संख्या ठेवण्याची अनुमतीसाठी बोली करण्याची आवश्यकता आहे - केवळ दहा वर्षे वैध असलेले महागारजामण्यांसाठी.	सिंगापूरमध्ये वाहन मालकांनी मर्यादित संख्येतील हक्क प्रमाणपत्रांसाठी बोली लावणे आवश्यक आहे – ज्या महागड्या ऑपरेटिंग परवानग्या फक्त दहा वर्षांसाठी वैध असतात.	सिंगापूरमध्ये वाहन मालकांना दहा वर्षांच्या कालावधीसाठी व्यावसायिक परवानग्या मिळविण्यासाठी निविदा सादर कराव्या लागतात.
The Hwasong-19 is North Korea’s biggest missile yet and its test comes during a time of notable tensions on the peninsula.	ह्वासोंग-१९ उत्तर कोरियाचा सर्वात मोठा पाटवं मिसाइल आहे आणि याची चाचणी प्राय: द्वीपक्षेत्रावर चि अवलंबून आली आहे.	ह्वासॉंग-१९ हे उत्तर कोरियाचे आतापर्यंतचे सर्वात मोठे क्षेपणास्त्र आहे आणि त्याची चाचणी द्वीपकल्पावर उल्लेखनीय तणावाच्या काळात होत आहे.	ह्वासोंग-१९ हे उत्तर कोरियाचे सर्वात मोठे मिसाइल आहे आणि त्याची चाचणी पेनिन्सुलावरील उल्लेखनीय तणावाच्या काळात होत आहे.
The species may have been carried to the Sacramento–San Joaquin Delta in ballast water on ships	या प्रजांची जलद जलयानांच्या बॅलस्ट पाण्यात सॅक्रामेंटो-सॅन जोव्हाॅकिन डेल्टात जाणे किंवा येऊ शकते.	प्रजाती जहाजांवरील बलास्ट पाण्यातून सॅक्रामेंटो–सॅन जोआक्विन डेल्टामध्ये नेल्या गेल्या असू शकतात.	जाती त्यांना सॅक्रामेंटो-सॅन जोक्विन डेल्टामध्ये जहाजांवरील बॅलस्ट वॉटरमध्ये नेल्या गेल्या असण्याची शक्यता आहे.
Discovery partnered with PR firm Relevance International to produce ultra-luxury experiences and products under the banner of fictionaire billionaire Bruce Wayne’s conglomerate.	डिस्कव्हरीने पीआर कंपनी रिलेवंस इंटरनॅशनलसोबत सहकार्य करून उल्ट्रा-लक्झरी अनुभवे आणि उत्पादने तयार करण्यात आली, या व्यापाराच्या ध्वजाखाली फिक्शनेयर बिलियनेअर ब्रूस वेनच्या संघटनेच्या.	डिस्कवरीने PR फर्म रिलेव्हन्स इंटरनॅशनलसोबत भागीदारी केली आहे ज्यायोगे काल्पनिक अब्जाधीश ब्रूस वेन यांच्या समूहाच्या बॅनरखाली अल्ट्रा-लक्झरी अनुभव आणि उत्पादने तयार केली जातील.	डिस्कवरीने पीआर फर्म रिलेव्हन्स इंटरनॅशनलसोबत भागीदारी केली आणि फिक्शनर बिलियनेर ब्रुस वेनच्या काँग्लोमरेटच्या बॅनरखाली अतिउच्च लक्झरी अनुभव आणि उत्पादने तयार केली.
Water utilities and chemical manufacturers are challenging the new EPA standards. 	पाणी वापरकर्त्यांच्या आणि रासायनिक उत्पादकांच्या नवीन EPA मानकांवर विरोध करणारी आहेत.	पाणी पुरवठा सेवा आणि रासायनिक उत्पादक नवीन EPA मानकांना आव्हान देत आहेत.	पाणी सुविधा आणि रासायनिक उत्पादक त्यांच्या नवीन ईपीए मानकांना आव्हान देत आहेत.
A radio station in Poland fired its on-air talent and brought in A.I.-generated presenters. An outcry over a purported chat with a Nobel laureate quickly ended that experiment.	पोलंडमधील एक रेडियो स्टेशनने त्याच्या ऑन-एअर टॅलेंटला नोकरीपटक केली आणि ए.आय.-द्वारे उत्पन्न केलेल्या प्रस्तुतकर्त्यांना आमंत्रित केले. एका नोबेल पुरस्कारीसह केलेल्या कथ्यातून उत्पन्न वादाचा वार हे प्रयोग लवकरात लवकर थांबवलं.	पोलंडमधील एका रेडिओ स्टेशनने त्यांच्या ऑन-एअर प्रतिभेला कामावरून काढून टाकले आणि कृत्रिम बुद्धिमत्ता-निर्मित प्रस्तुतकर्त्यांना आणले. एका नोबेल पुरस्कार विजेत्यांसोबतच्या कथित संभाषणावर झालेल्या आक्रोशामुळे तो प्रयोग लवकरच समाप्त झाला.	पोलंडमधील एक रेडिओ स्टेशनने त्यांचे ऑन-एअर प्रतिभावान कलाकारांना कामावरून काढून टाकले आणि एआय-जनरेटेड संचालकांना आणले. नोबेल पुरस्कार विजेत्याशी झालेल्या संभाव्य संवादावरून त्वरित त्या प्रयोगाचा अंत झाला.
From infancy, children show heightened interest in events that are impossible or improbable, relative to likely events.	शिशूंच्या प्रारंभिक वयात, संभाव्य किंवा असंभाव्य घटनांवर जास्त आव्हान दर्शवून देतात.	बालपणापासूनच, मुले अशक्य किंवा अशक्यप्राय घटनांमध्ये अधिक रुची दाखवतात, संभाव्य घटनांच्या तुलनेत.	बालपणापासून, ते मुले असंभव किंवा अप्राप्य घटनांमध्ये वाढीव स्वारस्य दाखवतात, संभाव्य घटनांच्या तुलनेत.
Four persons were referred to hospital and the rest were treated as outpatients at the event venue, police sources said.	चौदह व्यक्ति रुग्णालयात नेमण्यात येतले आणि इतर लोकांना कारगीरांच्या सूत्रांनुसार कार्यक्रमाच्या स्थळी रुग्णांसाठी औषध देण्यात आली.	चार व्यक्तींना रुग्णालयात पाठविण्यात आले आणि उर्वरितांना कार्यक्रम स्थळी बाह्यरुग्ण म्हणून उपचार करण्यात आले, असे पोलीस सूत्रांनी सांगितले.	चार व्यक्ती रुग्णालयात दाखल करण्यात आले आणि उर्वरीतांना स्थानिक स्थलावर OPD मध्ये व्यवस्थापित करण्यात आले, पोलीस स्रोतांनी सांगितले.
During investigation, the Washermenpet police found that he was attacked by three persons with stones and beer bottles while he was consuming alcohol.	चौघट पोलिसांनी चारण केलं की तो त्यांना दारू प्यायला असताना तिन्ही व्यक्तींनी पाठींद्यांसह आणि बीयर बॉटल्ससह हल्ला केला आहे.	चौकशीदरम्यान, वॉशरमेनपेट पोलिसांना आढळले की ते दारू पित असताना त्यांच्यावर तीन जणांनी दगड आणि बिअरच्या बाटल्यांनी हल्ला केला होता.	तपासणीदरम्यान, वाशेरमेनपेटच्या पोलिसांनी असे आढळून आले की त्याला तीन जणांनी दगडांनी व बियरच्या बॉटलनी त्याच्या मद्यपान करत असताना हल्ला केला होता.
Two juvenile boys who were lodged at the Government Observation Home in Chengalpattu escaped on Tuesday night.	चेंगलपट्टूतील सरकारी दृष्टिबंद घरात रात्री दोन किशोर पुरुष भागले होते.	चेंगलपट्टू येथील शासकीय निरीक्षण गृहात ठेवण्यात आलेले दोन अल्पवयीन मुले मंगळवारी रात्री पळून गेली.	दोन तरुण मुले जे चेंगलपट्टुमध्ये सरकारी निरीक्षण गृहात ठेवण्यात होते त्यांनी मंगळवार रात्री पलायन केले.
During Mr. Gandhi’s Srinagar stay, men disembarked from cars on Boulevard road to hug him.	सोमेश्वर गांधींच्या श्रीनगर विश्रांतीत, उर्वार सडकवरील कारांपासून माणसांनी त्यांना आलं.	श्री गांधी यांच्या श्रीनगरमधील मुक्कामादरम्यान, काही पुरुष बुलेवार्ड रस्त्यावर गाड्यांमधून उतरले आणि त्यांना मिठी मारली.	श्री गांधीजी सrinagar मध्ये राहात असताना, बुलेवार्ड रोडवरून गाड्यांतून उतरून त्यांना मिळाले.
They alleged that several brick kilns started selling old stocks of bricks from Wednesday after paying the first instalment of the fine levied on them by the Geology and Mining Department.	त्यांनी दावा केला की काही ईंटाचे किल्न त्यांच्यावर भूवैज्ञानिक आणि खनन विभागाने लगु केलेल्या दंडाच्या पहिल्या किंवा दुसऱ्या किस्तीच्या मुदतीच्या भुगतानानंतर बुधवारपासून जुन्या भंडाराच्या ईंटांची विक्री सुरु झाली.	त्यांनी आरोप केला की भूविज्ञान आणि खनन विभागाने त्यांच्यावर लादलेल्या दंडाच्या पहिल्या हप्त्याचा भरणा केल्यानंतर बुधवारपासून अनेक वीटभट्ट्यांनी जुन्या वीटसाठ्यांची विक्री सुरू केली.	त्यांनी आरोप केला की विभागाने त्यांच्यावर लादलेल्या दंडाचा पहिला हप्ता भरल्यानंतर बुधवारपासून काही इटक्या भट्ट्यांनी जुन्या स्टॉकच्या इटक्या विक्री सुरू केल्या.
Ten Indian career diplomats, who are High Commissioners or Ambassadors of India in other countries, called on Governor R.N. Ravi at the Raj Bhavan in Chennai on Monday.	भारताच्या इतर देशांमधील हाय कमीशनर किंवा दूतांचे उच्चाधिकारी असलेले दहा भारतीय पेशेवर व्यवसायकार, सोमवारी राज भवनात राज्यपाल आर.एन. रवींना भेट घेतले.	दहा भारतीय करिअर राजनैतिक अधिकारी, जे इतर देशांमध्ये भारताचे उच्चायुक्त किंवा राजदूत आहेत, यांनी सोमवारी चेन्नई येथील राजभवनात राज्यपाल आर.एन. रवी यांची भेट घेतली.	दहा भारतीय कारकून राजदूत, जे भारताचे इतर देशांतील उच्च आयुक्त किंवा राजदूत आहेत, सोमवारी चेन्नईतील राजभवन येथे राज्यपाल रा. ना. रवी यांची भेट घेतली.
However, Dr. Hande, who wrote the foreword for her book and took part in some of these Assembly debates, says Muthu discharged her duty efficiently as a Minister with no room for corruption.	तरीही, डॉ. हांडे, ज्यांनी त्यांच्या पुस्तकासाठी प्रस्तावना लिहिली आणि काही विधानसभा चर्चांमध्ये सहभाग घेतला, तो म्हणतात की मुथू भ्रष्टाचाराच्या काळाच्या बाबीं विभागाच्या प्रमुखसचिव म्हणून पदवी देते.	तथापि, डॉ. हांडे, जे त्यांच्या पुस्तकासाठी मनोगत लिहितात आणि या विधानसभेच्या काही चर्चांमध्ये सहभागी झाले होते, असे म्हणतात की मुथू यांनी मंत्री म्हणून आपले कर्तव्य अत्यंत कार्यक्षमतेने पार पाडले आणि भ्रष्टाचाराला कोणतीही जागा दिली नाही.	पण डॉक्टर हांडे यांनी, ज्यांनी तिच्या पुस्तकासाठी प्रस्तावना लिहिली आणि या विधानसभा चर्चेत सहभागी झाले, असे म्हणतात की मuthu यांनी त्यांचे मंत्री म्हणून कर्तव्य पार पाडले आणि भ्रष्टाचारासाठी कोणतीही जागा नव्हती.
While both Mr. Lobo and Mr. Kamat have cited disaffection with the Congress high command as reasons, the true reasons are all too transparent.	ज्यांनी म्हणजे श्री लोबो आणि श्री कामत दोघेही काँग्रेसच्या उच्च कमाणध्वनीसह नाराजी दर्शविल्यास, त्यांच्या असल्याची कारणे सर्वांना खुलासा आहेत.	श्री. लोबो आणि श्री. कामत यांनी काँग्रेस उच्च कमांडबद्दलची असंतोष कारणे म्हणून दर्शवली आहे, पण खरे कारणे अगदीच स्पष्ट आहेत.	ते लोबो साहेब आणि ते कामत साहेब यांनी काँग्रेस उच्च नेतृत्वाशी असमाधान म्हणून कारणे दिली आहेत, परंतु खरे कारणे सर्वस्वी स्पष्ट आहेत.
The first festival celebrating the linguistic and cultural ties between the Barak Valley region of Assam and the Sylhet segment of Bangladesh began on Friday evening.	असमाच्या बारक घाटी क्षेत्र आणि बांग्लादेशच्या सिल्हेट भागातील भाषाई आणि सांस्कृतिक संबंधांची पहिली उत्सव शुक्रवार रात्रीपासून सुरू झाली.	आसामच्या बऱाक व्हॅली प्रदेश आणि बांगलादेशाच्या सिल्हेट भागामधील भाषिक आणि सांस्कृतिक संबंध साजरे करणारा पहिला महोत्सव शुक्रवार संध्याकाळी सुरू झाला.	पहिला उत्सव आसामच्या बराक व्हॅली प्रदेश आणि बांगलादेशच्या सिलहट विभागातील भाषिक आणि सांस्कृतिक संबंधांचा साजरा शुक्रवार संध्याकाळी सुरू झाला.
The objective of such markets is to incentivise investments in renewable energy sources.	तुमच्या बाजारांचा उद्देश नवीन ऊर्जा स्रोतांमध्ये निवेश करण्याचा प्रेरणा देणे आहे.	अशा बाजारांचे उद्दिष्ट अक्षय ऊर्जा स्रोतांमध्ये गुंतवणूक करण्यास प्रोत्साहन देणे हे आहे.	त्या बाजारपेठांचे उद्देश्य पुनर्नवीकरणीय ऊर्जा स्रोतांमध्ये गुंतवणुकीला प्रोत्साहन देणे आहे.
The Centre is expected to clarify, later this year, the specifics of a carbon trading market in India.	केंद्राने भारतातील कार्बन व्यापाराच्या विशिष्टता या वर्षी नंतर स्पष्टीकरण करण्याची अपेक्षा आहे.	या वर्षाच्या उत्तरार्धात केंद्र सरकार भारतातील कार्बन व्यापार बाजारपेठेच्या तपशीलांचे स्पष्टीकरण देऊ शकेल अशी अपेक्षा आहे.	केंद्रीय प्राधिकरणे या वर्षात भारतातील कार्बन व्यापार बाजाराचे तपशील स्पष्ट करण्याची अपेक्षा आहे.
Hydrogen is an essential industrial fuel that has a range of uses from producing ammonia.	हायड्रोजन हा एक आवश्यक औद्योगिक ईंधन आहे ज्याला अमोनिया उत्पादन करण्यासाठी वापरला जातो.	हायड्रोजन हे एक आवश्यक औद्योगिक इंधन आहे, ज्याचा वापर अमोनिया निर्मितीपासून विविध प्रकारे केला जातो.	हायड्रोजन हे औद्योगिक इंधन आहे ज्याचा वापर अमोनिया तयार करण्यासाठी आणि इतर अनेक कामांसाठी होतो.
Finance Minister Nirmala Sitharaman on Saturday said that regulators would do their job.	वित्त मंत्री निर्मला सीतारमणे शनिवारी म्हणाली की नियायाधिकारी त्यांच्या काम करतील.	शनिवारी आर्थिक मंत्री निर्मला सीतारामन म्हणाल्या की नियामक आपले कार्य करतील.	आर्थिक मंत्री निर्मला सीतारामन यांनी शनिवारी सांगितले की नियामक त्यांचे काम करणार आहेत.
Madras has received a grant of ₹242 crore to do research on laboratory-grown diamonds.	मद्रासला लॅबरेटरीमध्ये वाढविलेल्या हीरा तपशील करण्यासाठी ₹२४२ कोटीची प्रोत्साहन दिलेली आहे.	मद्रासला प्रयोगशाळेत तयार केलेल्या हिऱ्यांवर संशोधन करण्यासाठी ₹२४२ कोटींचा अनुदान प्राप्त झाला आहे.	मद्रासला लॅबोरेटरीवर वाढवलेल्या हिरावंती संशोधनासाठी २४२ कोटी रुपयांचा अनुदान मिळाला आहे.
Before Rao took leave after the meeting, MGR gently reminded him of the Cauvery water.	बैठक संपल्यानंतर राव राजा लावून जाण्यापूर्वी, एमजीआर त्यांना कावेरीच्या पाण्याची लक्षात घेतली.	सभेच्या शेवटी राव साहेब रजा घेत असताना एमजीआर यांनी त्यांना सौम्यपणे कावेरी पाण्याची आठवण करून दिली.	राव साहेबांनी बैठकीनंतर सुट्टी घेतल्यापूर्वी, एमजीआर साहेबांनी त्यांना कावेरी पाण्याची आठवण करून दिली.
It is because of this initiative that Tamil Nadu became the centre of higher learning.	या प्रयत्नाने तमिळनाडू महाविद्यापीठाचे केंद्र झाले आहे.	याच उपक्रमामुळे तमिळनाडू उच्च शिक्षणाचे केंद्र बनले.	त्यामुळे तमिळनाडू उच्च शिक्षणाचे केंद्र झाले आहे.
However, within minutes after the then Prime Minister intervened.	तरीही, त्याच्या अवधीन विधानसभेच्या प्रमुखांनी बघता.	तथापि, त्या वेळच्या पंतप्रधानांनी हस्तक्षेप केल्यानंतर काही मिनिटांत.	पण त्या वेळी प्रधानमंत्र्यांनी हस्तक्षेप केल्यानंतर काही मिनिटांतच.
The initial shock following the Taliban’s seizure of power in Kabul is waning.	काबुलमध्ये तालिबानच्या शक्तीच्या आघातानंतरची प्रारंभिक अचंता कमी होत आहे.	काबुलमध्ये तालिबानने सत्ता हस्तगत केल्यानंतरचा प्रारंभिक धक्का कमी होत आहे.	तालिबानच्या काबुलवरील सत्ता हस्तगतीनंतरचा प्रारंभिक धक्का कमी होत आहे.
The greatest impact of denial of rights for women in the workforce would be a sharp contraction in the economy.	महिलांच्या कामकाजातील हक्कांचे नकारात्मक प्रभाव सबंधित अर्थव्यवस्थेत एक कठोर क्षय देणारा असेल.	कामकाजाच्या ठिकाणी महिलांच्या हक्कांच्या नाकारण्याचा सर्वात मोठा परिणाम म्हणजे अर्थव्यवस्थेत तीव्र संकुचन होईल.	महिलांना कार्यस्थळावर हक्कांचे नाकारणे हे अर्थव्यवस्थेवर सर्वात मोठा परिणाम असेल तो अर्थव्यवस्थेचा तीव्र संकुचन होईल.
The Taliban do not shy from leveraging the issue to gain international attention.	टालिबान आंतरराष्ट्रीय लक्षात गेल्याच्या समस्येचा अवलंब करण्यास थेंबल नाहीत.	तालिबान आंतरराष्ट्रीय लक्ष वेधून घेण्यासाठी या मुद्द्याचा फायदा घेण्यास मागेपुढे पाहत नाहीत.	तालिबान त्या प्रश्नाचा वापर आंतरराष्ट्रीय लक्षवेध मिळविण्यासाठी संकोच करत नाहीत.
In Jammu and Kashmir, the enrolment dropped sharply from 1.78 lakh in 2019-20 to 1.31 lakh in 2020-21.	जम्मू आणि काश्मीरमध्ये, २०१९-२० मध्ये १.७८ लाख विद्यार्थ्यांची नोंदणी २०२०-२१ मध्ये १.३१ लाख विद्यार्थ्यांकडे अचानक कमी झाली.	जम्मू आणि काश्मीरमध्ये, 2019-20 मध्ये 1.78 लाखांवरून 2020-21 मध्ये 1.31 लाखांपर्यंत नोंदणी तीव्रपणे कमी झाली आहे.	जम्मू आणि काश्मीरमध्ये, त्यांची नोंदणी २०१९-२० मध्ये १.७८ लाख वरून २०२०-२१ मध्ये १.३१ लाख एवढी घसरली.
Senior advocate Meenakshi Arora made the oral mentioning for early hearing.	मुख्य वकीला मीनाक्षी अरोरा ने शीघ्र सुनवाई के लिए मौखिक उल्लेख किया।	वरिष्ठ वकील मीनाक्षी अरोरा यांनी लवकर सुनावणीसाठी मौखिक उल्लेख केला.	वरिष्ठ वकील मीनाक्षी अरोरा यांनी लवकर सुनावणीसाठी तोंडी निवेदन केले.
The State had never forced students out of State schools by restricting hijab.	राज्याने कधीही हिजाब वर प्रतिबंध लागू करून राज्यशालेय मुलांना बाहेर काढायला मजबूर केलं नाही.	राज्याने कधीही विद्यार्थ्यांना राज्य शाळांमधून हिजाबवर निर्बंध लावून बाहेर काढले नाही.	त्यांनी कधीही राज्य शाळांमधून विद्यार्थ्यांना हिजाबच्या मर्यादेमुळे बाहेर केले नाही.
The patient has the right to refuse to participate in such research projects.	रुग्णांना इतर संशोधन प्रकल्पांमध्ये सहभागी होण्याचा अधिकार नाही, तो त्याच्याकडून नकार देण्याचा हक्क आहे.	रुग्णांना अशा संशोधन प्रकल्पांमध्ये सहभागी होण्यास नकार देण्याचा अधिकार आहे.	ते रुग्णाला अशा संशोधन प्रकल्पात भाग घेण्यास नकार देण्याचा अधिकार आहे.
The field officials should remember it while implementing projects. 	क्षेत्रीय अधिकारींनी कार्यक्रमे कार्यान्वित करताना ह्याचा लक्ष ठेवावा.	प्रकल्प राबविताना क्षेत्रीय अधिकारी याची आठवण ठेवा.	क्षेत्र अधिकारी त्यांनी प्रकल्प राबविताना ते लक्षात ठेवावे.
Senior officials in the Ministry of Tribal Affairs said a change in the structure had already been approved.	माननीय आदिवासी कल्याण मंत्रालयातील ज्येष्ठ अधिकारींनी सांगितलं की संरचनेत काही बदल केलं जातं आहे आधीच मान्यता मिळाली आहे.	आदिवासी कार्य मंत्रालयातील वरिष्ठ अधिकाऱ्यांनी सांगितले की, संरचनेत बदल करण्यास आधीच मंजुरी देण्यात आली आहे.	महामंडळाच्या आदिवासी कार्य मंत्रालयातील वरिष्ठ अधिकारी म्हणाले की संरचनेतील बदल त्यांनी आधीच मंजूर केला आहे.
The Bhagwan Mahaveer Foundation has called for applications for the Mahaveer awards.	भगवान महावीर निधि ने महावीर पुरस्कारांसाठी अर्जांसाठी आहात.	भगवान महावीर फाउंडेशन यांनी महावीर पुरस्कारांसाठी अर्ज मागवले आहेत.	भागवान महावीर फाउंडेशनने महावीर पुरस्कारांसाठी अर्ज मागितले आहेत.
Mr. Yediyurappa resigned as Chief Minister and was succeeded by Basavaraj Bommai in 2020.	येदियुरप्पा मुख्यमंत्री पदाचा राजीनामा दिला आणि २०२० मध्ये त्यांच्या स्थानी बासवराज बोम्मईंने स्वतः दरबारी ग्रहण केलं.	श्री येडियुरप्पा यांनी मुख्यमंत्री पदाचा राजीनामा दिला आणि २०२० मध्ये बसवराज बोम्मई यांनी त्यांची जागा घेतली.	त्यांनी मुख्यमंत्री पदाचा राजीनामा दिला आणि २०२० मध्ये त्यांच्यानंतर बसवराज बोम्मई यांनी त्या पदाची धुरा स्वीकारली.
The rescuers had to cut the roof of the lift to bring them out, and nobody was hurt.	उद्धारकारकांनी त्यांना बाहेर निकालण्यासाठी लिफ्टच्या छत्रावर कापणे आवश्यक होते, आणि कोणीही जखमी झालेले नव्हते.	रक्षकांना त्यांना बाहेर आणण्यासाठी लिफ्टचे छत कापावे लागले, आणि कोणीही जखमी झाले नाही.	त्यांनी लिफ्टच्या छपराचे तुकडे काढून त्यांना बाहेर काढले, आणि कोणालाही इजा झाली नाही.
The group claimed another police station attack in Rask that killed one officer on January 10.	जन समर्थन मिळवणारे एका पोलीस ठाण्याच्या हल्ल्याच्या घटनेत दिनांक १० जानेवारीला रास्कमध्ये एक अधिकाऱ्याला मारुन मृत्यू होण्याची दावा केली.	समूहाने १० जानेवारी रोजी रास्क येथील एका पोलीस स्टेशनवरील हल्ल्याची जबाबदारी घेतली, ज्यात एक अधिकारी ठार झाला.	त्या गटाने रास्क येथे १० जानेवारीला एका अधिकाऱ्याचा मृत्यू झालेला आणि पोलीस स्टेशनवरील दुसरा हल्ला केल्याचा दावा केला.
Based on the complaint, an FIR has been registered against Constable Shailendra Singh and three other policemen.	दुसरे पोलिस अधिकाऱ्यांवर आधारित शिकायतीनुसार, एफआयआर शैलेंद्र सिंग आणि तीन इतर पोलिसांवर दाखल केल्या गेलेल्या आहे.	तक्रारीच्या आधारे हवालदार शैलेन्द्र सिंह आणि इतर तीन पोलिसांविरुद्ध एफआयआर नोंदवली गेली आहे.	त्या तक्रारीवरून, कॉन्स्टेबल शैलेंद्र सिंह यांच्या विरोधात आणि तीन इतर पोलीस अधिकाऱ्यांच्या विरोधात एफआयआर नोंदविण्यात आला आहे.
Financial institutions also play a crucial role in tracking the money trails sustaining these networks.	वित्तीय संस्थांनी ही नेटवर्क्स संचालित करणार्‍या पैसाच्या ट्रेल्सचे ट्रॅकिंग करण्यात महत्वाची भूमिका बजावू लागतात.	आर्थिक संस्थांकडून या जाळ्यांना आधार मिळवून देणाऱ्या आर्थिक मार्गांचा मागोवा घेण्यात देखील महत्त्वपूर्ण भूमिका बजावली जाते.	आर्थिक संस्थाने देखील या नेटवर्क्सच्या पैसा ट्रेल्सच्या निरीक्षणात महत्त्वाची भूमिका बजावतात.
It is laudable that customs duties have been waived on three anti-cancer drugs.	तिन्ही गर्वनीय आंटी-कॅन्सर औषधींवर शुल्क माफ केलं जाण्याचं अद्भुत आहे.	तीन कर्करोगविरोधी औषधांवरील सीमाशुल्क माफ केल्याबद्दल आपल्या (आपण) कौतुकास पात्र आहात.	त्यांनी तीन कर्करोग विरोधी औषधांवरील सीमा शुल्क माफ केले असे प्रशंसनीय आहे.
Inside the final sprint in the biggest battleground state on the map.	मानचित्रावरील सर्वात मोठ्या युद्धस्थळावर शेवटच्या स्प्रिंटमध्ये.	नकाशावरील सर्वात मोठ्या रणांगण राज्यातील अंतिम धावपटूत आत.	आखरीच्या स्प्रिंटच्या आत, नकाशावरील सर्वात मोठ्या लढाईच्या राज्यात.
All eyes are on America as an uncertain world awaits election result.	सर्व दृष्टी अमेरिकेवर आहे जस अनिश्चित जगात निवडणूकच्या निकालाचा वाट पाहत आहे.	संपूर्ण जगाचे लक्ष अमेरिकेकडे लागले आहे कारण एक अनिश्चित जग निवडणुकीच्या निकालाची प्रतीक्षा करत आहे.	अमेरिकेच्या निवडणुकीच्या निकालाची वाट पाहत आहेत त्या अनिश्चित जगाची सर्व डोळे.
Twitch faces criticism over Israel-Gaza war content on platform.	त्विचला मंचावर इजरायल-गाझा युद्धाबद्दल आलोचना भोगावी.	Twitch प्लॅटफॉर्मवरील इस्रायल-गाझा युद्धाच्या विषयावरच्या सामग्रीबद्दल टीकेला सामोरे जात आहे.	ट्विचला इस्रायल-गाजा युद्ध संबंधी प्लॅटफॉर्मवरील सामग्रीवर टीका होत आहे.
North Korea fires multiple ballistic missiles toward the sea ahead of U.S. election.	उत्तर कोरिया अमेरिकन निवडणुकीच्या आगामी दिवशी समुद्रावर अनेक बॉलिस्टिक मिसाईल्स कसरत करते.	उत्तर कोरियाने अमेरिकेच्या निवडणुकीच्या पूर्वी समुद्राकडे अनेक क्षेपणास्त्रे डागली आहेत.	उत्तर कोरियाने समुद्राकडे अमेरिकेच्या निवडणुकीच्या पूर्वी अनेक बॅलिस्टिक मिसाइल्स सोडल्या.
Singapore Airlines will add first class, revamp cabins for longest flights.	सिंगापूर एअरलाईंसने सर्वात मोठ्या उड्डाणांसाठी पहिल्याच वर्गाची भरपूरता करण्यात येणार आहे, दीर्घतम फ्लाय्ट्ससाठी केबिन्स दुरुस्तीकरण करणार आहे.	सिंगापूर एअरलाइन्स त्यांच्या सर्वात लांब उड्डाणांसाठी प्रथम श्रेणी जोडतील आणि केबिनचे नूतनीकरण करतील.	सिंगापूर एरलाइन्स त्यांचे प्रथम श्रेणी जोडतील, लांब प्रवासासाठी केबिन्सचा नवीनीकरण करणार आहेत.
Priyanka Chopra Jonas and Nick Jonas celebrate 'Diwaloween,' Diwali and Halloween mashup.	प्रियंका चोप्रा जोनस आणि निक जोनस 'डिव्हालोव्हीन', दिवाळी आणि हॅलोवीनचं मॅशअप साजरा करतात.	प्रियंका चोप्रा जोनास आणि निक जोनास 'दिवालोवीन', दिवाळी आणि हॅलोवीन यांचा एकत्र सण साजरा करतात.	प्रियांका चोप्रा जोनास आणि निक जोनास त्यांचे 'डिवालोवीन' साजरे करतात, दिवाळी आणि हॅलोवीनचा मिलाफ.
Pennsylvania officials denounce Halloween float appearing to depict Harris tied to golf cart.	पेन्सिल्व्हेनिया अधिकाऱ्यांनी हॅलोविन फ्लोटवर हॅरिसची गोल्फ कार्टवर बांधून दिसणारी व्यंग्यपूर्ण चित्रपटे निनादित केल्याची निंदा केली.	पेनसिल्व्हेनियाचे अधिकारी हॅलोविन फ्लोटवर हरिस यांना गोल्फ कार्टला बांधलेल्या स्वरूपात दर्शविण्याचा निषेध करतात.	पेन्सिल्व्हानिया अधिकारी हॅरिसला गोल्फ कार्टला बांधलेले दिसणारे हॅलोवीन फ्लोटची निंदा करतात.
Elon Musk's election-doubting posts shared 9 times more than his less extreme election content.	इलॉन मस्कच्या निवडणूकविषयी शंका करणार्या पोस्ट्सचा वाटप 9 पटकाही त्याच्या कमी प्रमाणातील निवडणूक सामग्रीपेक्षा अधिक केला गेला.	एलोन मस्क यांचे निवडणुकीबद्दल शंका घेणारे पोस्ट्स त्यांच्या कमी तीव्र निवडणूक विषयक सामग्रीपेक्षा ९ पट अधिक वेळा शेअर करण्यात आले आहेत.	एलोन मस्क यांच्या निवडणुकीच्या शंका व्यक्त करणार्या पोस्ट्स त्यांच्या कमी अति निवडणुकीच्या सामग्रीवर ९ पट जास्त विभागल्या गेल्या.
Americans eye the economy from kitchen tables and hourly jobs as they plan their votes.	आमेरिकन लोक त्यांच्या मतदानाची योजना करताना रसोईच्या मेजवरून आणि तासांच्या कामांपासून अर्थव्यवस्थेवर दृष्टी ठेवतात.	अमेरिकन लोक त्यांच्या स्वयंपाकघरातील टेबलांवरून आणि तासागणिक नोकऱ्यांमधून अर्थव्यवस्थेकडे पाहतात, कारण ते त्यांच्या मतांची योजना आखतात.	अमेरिकन त्यांच्या अर्थव्यवस्थेकडे घरगुती मेजवरून आणि तासिक नोकर्यांमधून त्यांची मते ठरवतात.
Quincy Jones, musical maestro and entertainment industry titan, dies at 91.	क्विंसी जोन्स, संगीत कलावंत आणि मनोरंजन उद्योगातील विशालकाय, ९१ वर्षांच्या वयाने मुंबईत मृत्यू झाले.	संगीत क्षेत्रातील महान व्यक्तिमत्व आणि मनोरंजन उद्योगाचे दिग्गज, क्विन्सी जोन्स, वयाच्या ९१व्या वर्षी दिवंगत झाले.	क्विंसी जोन्स, संगीताचे महारथी आणि मनोरंजन उद्योगाचे दिग्गज, ९१ वर्षांचे वयात निधन पावले.
Proud Boys claim they'll be at polling places as Trump ups violent rhetoric and fraud claims	गर्वित मुली दावेदारी करतात की ते मतदान केंद्रात उपस्थित असणार असून ट्रम्पची हिंसात्मक भाषण आणि धोखाधडी दावे वाढत आहेत.	"""प्राउड बॉयज म्हणतात की ते मतदान केंद्रांवर असतील, कारण ट्रम्प हिंसक भाषा आणि फसवणुकीच्या दाव्यांना प्रोत्साहन देत आहेत."""	त्या प्राउड बॉयज सांगतात की ते मतदान केंद्रांवर असतील जेव्हा ट्रंप हिंसक भाषण व फ्रॉडचे दावे वाढवतात.
One of the police officers stumbled to the ground when the driver applied brakes and attempted to strike him.	पोलीस अधिकाऱ्यांमध्ये एक अधिकाऱ्या जब ड्रायव्हर ब्रेक लावताना गाडी चालवली आणि त्याला मारण्याचा प्रयत्न केला तेव्हा जमिनीवर टिकला.	जेव्हा चालकाने ब्रेक लावले आणि त्यांना धक्का देण्याचा प्रयत्न केला, तेव्हा पोलिस अधिकाऱ्यांपैकी एकजण जमिनीवर पडला.	एक पोलीस अधिकारी त्यांना जमिनीवर कोसळले जेव्हा चालकाने ब्रेक लावले आणि त्यांच्यावर हल्ला करण्याचा प्रयत्न केला.
The authorities confirmed they have identified the vehicle's owner and expect to make an arrest shortly.	प्राधिकरणांनी सापडलं की वाहनाच्या मालकाची ओळख केली आहे आणि लवकरात लवक अटक करण्याची अपेक्षा आहे.	अधिकार्‍यांनी पुष्टी दिली आहे की त्यांनी वाहनाच्या मालकाची ओळख पटवली आहे आणि लवकरच अटक करण्याची अपेक्षा आहे.	त्या अधिकार्‍यांनी त्यांनी वाहनाच्या मालकाची ओळख पटविली असून लवकरच अटक करण्याची अपेक्षा आहे.
The Chhatrapati Shivaji statue in the Arabian Sea off the Mumbai coast is referred to as a precedent for the proposed pen memorial.	मुंबई तटावरील अरब समुद्रातील छत्रपती शिवाजी अटकावणारं मूर्तीला प्रस्तावित कल्ला सादर करण्याच्या साठी आधार म्हणून स्त्रोत आहे.	मुंबई किनाऱ्याच्या अरबी समुद्रातील छत्रपती शिवाजींचा पुतळा हा प्रस्तावित पेन स्मारकासाठी एक आदर्श मानला जातो.	छत्रपती शिवाजी Maharajांचा अरबी समुद्रात मुंबई किनारपट्टीवरील पुतळा प्रस्तावित पेन स्मारकासाठी आदर्श म्हणून ओळखला जातो.
Several political parties have opposed the pen memorial in the proposed location.	काही राजकीय पक्ष अनुमित ठिकाणावर लेखन आदराच्या स्मारकाविरुद्ध विरोध केले आहे.	प्रस्तावित ठिकाणी असलेल्या पेन स्मारकाला अनेक राजकीय पक्षांनी विरोध केला आहे.	अनेक राजकीय पक्षांनी प्रस्तावित स्थानावरील कalam Smarakाला विरोध केला आहे.
They have not taken into consideration the rainfall data of 2015 or years thereafter. 	त्यांनी २०१५ वर्षाच्या किव्हा त्यानंतरच्या वर्षांची पाऊस तथ्यांची ध्यान न घेतलं.	त्यांनी 2015 किंवा त्यानंतरच्या वर्षांचा पर्जन्यमान डेटा विचारात घेतलेला नाही.	त्यांनी २०१५ च्या किंवा त्यानंतरच्या वर्षांचे पावसाचे आकडे विचारात घेतले नाहीत.
The museum has been equipped with multimedia content, QR codes and holograms.	संग्रहणालयात मल्टिमिडिया सामग्री, QR कोड आणि होलोग्राम लागू केले आहे.	संग्रहालयाची बहुप्रतिमा सामग्री, QR कोड आणि होलोग्रामसह सजावट करण्यात आली आहे.	त्यांनी संग्रहालयाला मल्टिमीडिया सामग्री, क्यूआर कोड आणि होलोग्राम्सनी सुसज्जित केले आहे.
The ninth phase of the excavations would begin later this month, said officials.	अधिकाऱ्यांनी म्हणाले की उत्तराणाच्या नव्या टप्प्याची नवीन पाळणी या महिन्यात आरंभ होईल.	अधिकाऱ्यांनी सांगितले की, उत्खननाचा नववा टप्पा या महिन्याच्या शेवटी सुरू होईल.	नवव्या टप्प्यातील उत्खनने या महिन्यात नंतर सुरू होतील, असे अधिकारी म्हणतात.
Mr. Reddy is a close relative of Taraka Ratna's wife Alekya Reddy.	रेड्डी सर, तारका रत्नांच्या पत्नी अलेक्या रेड्डीचा एक जवळजवळी संबंधी आहे.	श्री. रेड्डी हे तारक रत्न यांच्या पत्नी आलेख्या रेड्डी यांच्या जवळच्या नातेवाईक आहेत.	श्री. रेड्डी हे तारका रत्नाच्या पत्नी अलेक्या रेड्डी यांचे नातेवाईक आहेत.
This betrays an inexplicable hostility towards knowledge creation of all kinds. 	हे सर्व प्रकारच्या ज्ञान सृष्टीच्या दिशेने अव्याख्यात शत्रुता दाखवते.	हे सर्व प्रकारच्या ज्ञान निर्मितीबद्दल एक अनाकलनीय वैरभाव दर्शवते.	हे सर्व प्रकारच्या ज्ञान निर्मितीच्या प्रति अस्पष्ट वैर व्यक्त करते.
The second is what he calls alienation from the process of labour.	दुसरा तो तोंडाला कामची प्रक्रियेतून परतणार असे ते वाचतो.	दुसरे म्हणजे ते कामाच्या प्रक्रियेपासून疏ंवेदनशीलतेला म्हणतात.	दुसरे म्हणजे त्यांना कामाच्या प्रक्रियेपासून परकीयकरण म्हणतात.
In the process, Marx argued, workers become miserable.	प्रक्रियेत, मार्क्स त्यांच्या अभिप्रायानुसार, कामगार दुर्दैवी होतात.	या प्रक्रियेत, मार्क्सनी मांडले की कामगार दु:खी होतात.	त्या प्रक्रियेत, मार्क्स यांनी तर्क केला की कामगार यांची दयनीय स्थिती होते.
He asked the people to compare the scale of development in the adjoining Assam during eight years of BJP rule.	त्यांनी लोकांना विनंती केली की बीजेपीच्या आठ वर्षांच्या शासनात आसाममध्ये विकासाचे मापदंड तुलनात्मक करावे.	त्यांनी लोकांना आठ वर्षांच्या भाजप राजवटीदरम्यान शेजारच्या आसाममधील विकासाच्या प्रमाणाची तुलना करण्यास सांगितले.	त्यांनी लोकांना आसाममधील आठ वर्षांच्या भाजप सरकारच्या कालावधीतील विकासाच्या प्रमाणाची तुलना करण्यास सांगितले.
The DMK MP also said that the Budget presented by Union Finance Minister Nirmala Sitharaman had neglected sectors such as education, health and agriculture.	DMK चे सांसदही खालीलप्रमाणे सांगितलं की केंद्रीय वित्त मंत्री निर्मला सीतारमण यांनी पेश केलेलं बजेट शिक्षण, आरोग्य आणि कृषी इत्यादी क्षेत्रांना उपेक्षित केलं होतं.	डीएमके खासदारांनी असेही म्हटले की केंद्रीय अर्थमंत्री निर्मला सीतारामन यांनी सादर केलेल्या बजेटमध्ये शिक्षण, आरोग्य आणि कृषी अशा क्षेत्रांकडे दुर्लक्ष करण्यात आले आहे.	डीएमके संसद सदस्यांनीही म्हटले की केंद्रीय अर्थमंत्री निर्मला सीतारामन यांनी सादर केलेल्या अर्थसंकल्पात शिक्षण, आरोग्य आणि कृषी या क्षेत्रांना दुर्लक्ष केले आहे.
The accident took place around 3 p.m. on a State highway close to Korar village.	दुर्घटना सरकारी हायवेवरील कोरार गावासमोर उद्या दुपारी ३ वाजता घडली.	अपघात दुपारी ३ वाजण्याच्या सुमारास कोरार गावाजवळील राज्य महामार्गावर झाला.	आपणाला ३ वाजता स्टेट हायवे वर कोरार गावाजवळ एक अपघात घडला.
Both the survivors are being treated at a hospital in Raipur.	दोन्ही उर्वरांची रायपुरातील एक रुग्णालयात उपचार घेत आहेत.	रायपूर येथील रुग्णालयात दोन्ही बचावलेल्यांवर उपचार केले जात आहेत.	ते दोन जखमी रायपूरमधील एका रुग्णालयात उपचार घेत आहेत.
Chief Minister Bhupesh Baghel took to Twitter to express grief over the accident.	मुख्यमंत्री भूपेश बघेल ने दुर्घटनेबद्दल दु:ख व्यक्त करण्यासाठी ट्विटरवर गेले.	मुख्यमंत्री भूपेश बघेल यांनी अपघाताबद्दल दु:ख व्यक्त करण्यासाठी ट्विटरचा वापर केला.	मुख्यमंत्री भूपेश बघेल यांनी ट्विटरवर दुर्घटनेवर शोक व्यक्त केला.
The Indian Institute of Technology Madras (IIT-M) Research Park hosted a competition for children.	भारतीय प्रौद्योगिकी संस्थान मद्रास (आईआईटी-एम) अनुसंधान पार्कने मुलांसाठी एक प्रतियोगिता आयोजित केली.	भारतीय तंत्रज्ञान संस्था मद्रास (IIT-M) संशोधन उद्यानाने मुलांसाठी एक स्पर्धा आयोजित केली.	भारतीय तंत्रज्ञान संस्था, मद्रास (आयआयटी-एम) संशोधन उद्यानाने बालांसाठी स्पर्धा आयोजित केली.
"External affairs minister S Jaishankar on Tuesday expressed concern over the attack on a Hindu temple in Canada, describing the incident as ""deeply concerning."	"मंत्रिमंडळाने बुधवारी हिंदू मंदिरावरील हल्ल्यावर चिंता व्यक्त केली, घटनेचा नाव ""गंभीर चिंता"" म्हणून वर्णन केला."	"मंगळवारी परराष्ट्र मंत्री एस. जयशंकर यांनी कॅनडामधील हिंदू मंदिरावरील हल्ल्याबद्दल चिंता व्यक्त केली आणि त्या घटनेला ""खूपच चिंताजनक"" असे वर्णन केले."	"विदेश मंत्र्यांनी मंगळवारी कॅनडातील हिंदू मंदिरावरील हल्ल्याबद्दल चिंता व्यक्त केली, ही घटना ""अत्यंत चिंताजनक"" असल्याचे सांगितले."
Modi condemns violence after Canada temple inciden.	मोदीजी कॅनडा मंदिर हल्ल्याचे नंदाद निंदा करतात.	मोडी यांनी कॅनडा मंदिर घटनेनंतर हिंसाचाराचा निषेध केला आहे.	मोदी त्यांनी कॅनडा मंदिर प्रकरणानंतर हिंसाचाराची निंदा केली.
Mr Nijjar had been a vocal supporter of the Khalistan movement and publicly campaigned for it.	निज्जर सरदार आंदोलनाचे एक उच्च समर्थक होते आणि त्याने सार्वजनिकपणे त्याचा प्रचार केला होता.	श्री निज्जर हे खलिस्तान चळवळीचे सक्रिय समर्थक होते आणि त्यांनी त्यासाठी सार्वजनिकरित्या प्रचार केला होता.	श्री निज्जार साहेबांनी खालिस्तान चळवळीचे प्रबल समर्थक होते आणि त्यासाठी सार्वजनिकपणे प्रचार केला होता.
Bangladesh steps up repayments to Adani to avoid power supply cu.	बांग्लादेश अदानीला विद्युत आपूर्ती कट्टा टाळण्यासाठी कर्जाची चुकवणी वाढवत आहे.	बांगलादेश वीज पुरवठ्यातील कपातीला टाळण्यासाठी अदानींना परतफेडीची रक्कम वाढवतात.	बांगलादेश आदानीला कर्ज फेडण्यासाठी वीज पुरवठा कात टाळण्यासाठी पावले वाढवत आहेत.
The country is already suffering from increased power shortages in rural areas.	देशात आधीच ग्रामीण क्षेत्रात विद्युत अभावाची समस्या वाढत आहे.	देशातील ग्रामीण भागात वाढत्या वीजटंचाईमुळे देश आधीच त्रस्त आहे.	देशाला ग्रामीण भागात वीज पुरवठ्यात वाढती कमतरता आलेली आहे.
Officials said 44 people were on board when the driver lost control and the bus fell into a 50m-deep ditch in Marchula, located in the state’s Almora district.	अधिकाऱ्यांनी सांगितलं की, ड्रायव्हरने नियंत्रण गमवल्यावर बसामध्ये 44 लोक असताना बस मार्चुला, जिल्हा आल्मोरा, राज्यातील ठिकाणी 50 मीटर गहिरा खोद गेला.	अधिकाऱ्यांनी सांगितले की, जेव्हा चालकाचा ताबा सुटला तेव्हा बसमध्ये ४४ लोक होते आणि बस राज्याच्या अल्मोडा जिल्ह्यातील मार्चुला येथे ५० मीटर खोल दरीत कोसळली.	अधिकारी म्हणाले की बसमध्ये ४४ जण चालले होते जेव्हा चालकाने नियंत्रण गमावले आणि बस मार्चुला येथील अल्मोरा जिल्ह्यातील ५० मीटर खोल गटारात पडली.
Uttarakhand's Chief Minister Pushkar Singh Dhami has also announced financial assistance for the victims and their families.	उत्तराखंडचे मुख्यमंत्री पुष्कर सिंह धामीने पीडितांच्या आणि त्यांच्या कुटुंबांसाठी आर्थिक सहाय्य घोषित केलं आहे.	उत्तराखंडचे मुख्यमंत्री मा. पुष्कर सिंह धामी यांनी पीडित आणि त्यांच्या कुटुंबीयांसाठी आर्थिक सहाय्य देण्याची घोषणा केली आहे.	उत्तराखंडचे मुख्यमंत्री पुष्कर सिंह धामी यांनीही पीडितांच्या व त्यांच्या कुटुंबीयांसाठी आर्थिक मदत जाहीर केली आहे.
Our scientists used it as an incentive to develop their own technology.	आमच्या वैज्ञानिकांनी ते प्रेरणादायक म्हणून आपल्या स्वत:च्या प्रौद्योगिकी विकसित करण्याचा वापर केला.	आमच्या वैज्ञानिकांनी त्यांचा स्वतःचा तंत्रज्ञान विकसित करण्यासाठी त्याचा प्रोत्साहन म्हणून वापर केला.	त्यांचे वैज्ञानिकांनी त्याचा उपयोग स्वकीय तंत्रज्ञान विकसित करण्यासाठी प्रोत्साहन म्हणून केला.
Mylswamy Annadurai, chief of India’s first and second Moon missions and Mars mission, told the BBC that Isro employs far fewer people and pays lower salaries, which makes Indian projects competitive.	माझ्या भारताच्या पहिल्या आणि दुसऱ्या चंद्रयान मिशन्स आणि मंगळ मिशनचे मुख्य, मायल्स्वामी अन्नादुरै, बीबीसीला सांगितलं की इसरोने खूप कमी लोकांचा नियोग केला आहे आणि कमी वेतन देतं ज्यामुळे भारतीय प्रकल्प दरवाजा दिलेल्या आहेत.	भारताच्या पहिल्या आणि दुसऱ्या चंद्र मोहिमांच्या आणि मंगळ मोहिमेच्या प्रमुख, मायल्स्वामी अण्णादुराई यांनी बीबीसीला सांगितले की, इस्रो कमी लोकांना नोकरी देते आणि कमी वेतन देते, ज्यामुळे भारतीय प्रकल्प अधिक स्पर्धात्मक ठरतात.	मीलस्वामी अन्नादुरई, भारताच्या प्रथम आणि द्वितीय चंद्रमissionचे प्रमुख आणि मंगळ मिशनचे प्रमुख, त्यांनी बीबीसीला सांगितले की इस्रो कमी लोकांना रोजगार देते आणि कमी पगार देते, ज्यामुळे भारतीय प्रकल्प स्पर्धात्मक होतात.
Ex-district president of Bajrang Dal Gurgaon held for shooting at Gurgaon man.	बाजरंग दल गुरुगांवच्या जिल्हाध्यक्षांनी गुरुगांवतील एखाद्या व्यक्तीला गोली मारून अटक केलं.	बजरंग दल गुरगावच्या माजी जिल्हाध्यक्षांना गुरगावमधील व्यक्तीवर गोळीबार केल्याप्रकरणी अटक करण्यात आली आहे.	बजरंग दलाचे माजी जिल्हा अध्यक्ष गुरगांवचे पकडले गेले गुरगांवच्या नागरिकावर गोळीबार करण्यासाठी.
The legendary Bob Khathing led the expedition to peacefully integrate Tawang into India.	महान बॉब खाथिंग यांनी भारतात शांततेने तावांगच्या एकीकरणासाठी अभियान नेत्याने.	प्रसिद्ध बॉब खाथिंग यांनी तवांगला शांततेने भारतात समाविष्ट करण्यासाठी मोहिमेचे नेतृत्व केले.	खाथिंग साहेबांनी तवांगचे शांततापूर्ण भारतात विलीनीकरणासाठी मोहिम केली.
In 1939, after the Second World War broke out, Khathing joined the Indian Army and got an Emergency Commission as an officer.	१९३९ मध्ये, दुसरे विश्वयुद्ध प्रारंभ झाल्यानंतर, खातिंग भारतीय सेनेमध्ये सामी तरी कमीशन मिळवून नवीन ओळख मिळवितले.	१९३९ मध्ये, दुसऱ्या महायुद्धाला सुरुवात झाल्यानंतर, खाथिंग भारतीय सैन्यात सामील झाले आणि अधिकाऱ्यांच्या रूपात आपत्कालीन आयोग मिळवला.	१९३९ मध्ये, दुसऱ्या महायुद्धाचा प्रारंभ झाल्यानंतर, खाथिंग त्यांनी भारतीय सेनेत सामील झाले आणि त्यांना ऑफिसर म्हणून एक आपत्कालीन आयोग मिळाला.
At the end of the Second World War, the Emergency Commissioned officers in the Army were demobilised.	दुसर्या विश्व युद्धाच्या शेवटी, सैन्यातील आपत्कालीन अधिकारी नियुक्त केले गेले.	दुसऱ्या महायुद्धाच्या शेवटी, लष्करातील आपत्कालीन नियुक्त अधिकारी मुक्त करण्यात आले.	दुसऱ्या महायुद्धाच्या शेवटी, सेनेतील त्या आणि त्यांचे आपत्कालीन अधिकारी सोडले गेले.
Most of the senior cricketers were far from their best, especially against New Zealand.	अधिकांश मुकादमवाले खेळाडू आपल्या सर्वोत्तमपर्यंत दूर होते, विशेषतः न्यूझीलंडविरुद्ध.	बहुतेक वरिष्ठ क्रिकेटपटू त्यांच्या सर्वोत्तम प्रदर्शनापासून दूर होते, विशेषतः न्यूझीलंडविरुद्ध.	महत्त्वाचे सगळे ज्येष्ठ क्रिकेटपटू त्यांच्या सर्वोत्तमपासून दूर होते, विशेषतः न्यू झीलंडविरुद्ध.
