src	gpt_3_5_trans	gpt_4o_trans	ollama_trans
JMM says Soren's helicopter take off delayed over PM's security protocol, writes to President Murmu	JMM ప్రధాని భర్తీ ప్రోటోకాల్ వలన సోరెన్ చినుకులో దిగిందని అవగాహన చేస్తుంది, రాష్ట్రపతి ముర్ముకు రాయవచ్చు.	జేఎమ్మ్ పార్టీ ప్రధానమంత్రి భద్రతా నిబంధనల కారణంగా సోరెన్ గారి హెలికాప్టర్ టేకాఫ్ ఆలస్యం అయినట్లు పేర్కొంటూ, రాష్ట్రపతి ముర్ము గారికి లేఖ రాసారు.	జేఎంఎం చెబుతున్నది, ప్రధాని భద్రతా ప్రోటోకాల్ కారణంగా సోరెన్ హెలికాప్టర్ ప్రయాణం ఆలస్యం అయింది, రాష్ట్రపతి ముర్ముకు లేఖ వ్రాసారు.
The king who defied the British: Uncovering the tale of Pazhassi raja’s rebellion	బ్రిటిష్ విరుద్ధంగా ప్రతిపక్షించిన రాజా: పాఝసీ రాజా విద్రోహానికి సంబంధించిన కథనానికి పరదారణ చేసేది.	బ్రిటిష్‌కు వ్యతిరేకంగా తిరుగుబాటు చేసిన రాజు: పళసీ రాజా తిరుగుబాటు కథను బయటపెట్టడం.	బ్రిటీష్ వారిని ధిక్కరించిన రాజులు: పాళయి రాజాల తిరుగుబాటు కథను వెలికితీస్తున్నారు.
Vinesh Phogat's retirement U-turn predicted after her latest Instagram post creates buzz on social media	వినేష్ ఫోగాట్ విద్యార్జన ఉలికిన తరువాత ఆమె ఇంస్టాగ్రామ్ పోస్టు వలన సోషల్ మీడియాలో గుర్తించడంలో తరచుగానే ముందుకు వ్యతిరేకం ప్రవర్తించిందని భవిష్యత్తు అందించనిది.	వినేష్ ఫోగాట్ గారి తాజా ఇన్‌స్టాగ్రామ్ పోస్ట్ సామాజిక మాధ్యమాలలో చర్చలు సృష్టించడంతో, ఆమె పదవివిరమణ నిర్ణయంలో మార్పు రావచ్చని అంచనా వేస్తున్నారు.	వినేష్ ఫోగట్ గారు యొక్క రిటైర్మెంట్ యు-టర్న్ ఆమె లేటెస్ట్ ఇన్స్టాగ్రామ్ పోస్ట్ సోషల్ మీడియాలో క్రియేట్ బజ్ సృష్టించింది.
The Pennsylvania push: Kamala Harris, Donald Trump spend final campaign hours in swing state	పెన్సిల్వేనియా పుష్: కమలా హ్యారిస్, డొనాల్డ్ ట్రంప్ స్వింగ్ రాష్ట్రంలో చరిత్ర గడిచిన క్యాంపైన్ గంటలు ముగిస్తున్నాయి.	పెన్సిల్వేనియా ప్రయత్నం: కమలా హారిస్, డొనాల్డ్ ట్రంప్ తమ తుది ఎన్నికల ప్రచార గంటలను స్వింగ్ రాష్ట్రంలో గడుపుతున్నారు.	పెన్సిల్వేనియా పుష్: కమలా హారిస్, డొనాల్డ్ ట్రంప్ గారు స్వింగ్ స్టేట్లో చివరి ప్రచార గంటలు గడిపారు.
Delhi engulfed in smog, toxic foam in Yamuna: Pics that capture national capital's pollution woes	దిల్లీని కూపాలుతున్న ధూమము, యమునాలో విషపు ఫోమ్: రాష్ట్ర రాజధానికి వాతావరణ విలాపాలను ఆవిష్కరించే చిత్రాలు.	ఢిల్లీ పొగమంచుతో కప్పబడి ఉంది, యమునా నదిలో విషపూరిత నురుగు: జాతీయ రాజధానిలో కాలుష్య సమస్యలను చూపించే చిత్రాలు.	ఢిల్లీ స్మోగ్ లో మునిగిపోయింది, యమునాలో విషపూరిత ఫోమ్: జాతీయ రాజధాని యొక్క కాలుష్య సమస్యలను చిత్రీకరించే చిత్రాలు.
Will Muslim boycott of Kamala send Trump to the White House?	ముస్లిం కమలకు బహిష్కారము చేసినప్పుడు ట్రంప్‌ను వైట్ హౌస్కు పంపిందా?	కామలాను ముస్లింల బహిష్కరణ ట్రంప్ గారిని వైట్ హౌస్‌కు పంపుతుందా?	ముస్లిమ్లు కమలాను బహిష్కరిస్తే ట్రంప్ వైట్ హౌస్ కు వెళ్తారా?
Why Indian batters are struggling against left-arm spin	భారతీయ బ్యాటర్లు ఎడమ చెక్కల స్పిన్ వలన సంఘర్షిస్తున్నారు అంటున్నారు.	భారత బ్యాట్స్‌మన్‌లు ఎడమచేతి స్పిన్నర్లకు వ్యతిరేకంగా ఎందుకు కష్టపడుతున్నారు?	భారతీయ బ్యాటర్లు ఎడమచేతి స్పిన్ కి వ్యక్తిగతంగా ఇబ్బంది పడుతున్నారు.
JD Vance calls Kamala Harris 'trash' at Atlanta rally: 'In 2 days we're taking out the garbage'	జెడి వాన్స్ అట్లాంటా ర్యాలీలో కమలా హారిస్ని 'ట్రాష్' అంటూ పిలవాడు: '2 రోజుల్లో మేము స్వచ్ఛం చేస్తున్నాం'	JD వాన్స్ అట్లాంటా ర్యాలీలో కమల హ్యారిస్‌ను 'చెత్త' అని పిలుస్తున్నారు: 'ఇంకా రెండు రోజుల్లో మేము చెత్తను తీసివేస్తున్నాం'	జేడ్ వాన్స్ అట్లాంటా ర్యాలీలో కమలా హారిస్ ను 'చెత్త' అని పిలుస్తారు: '2 రోజుల్లో మేము చెత్తను తొలగిస్తాము'
Meghan and Harry feel life in US hasn't been what they expected: Ex-staff	మెగన్ మరియు హ్యారీ అమరికలో జీవనం అంటే అవారా అంటున్నారు: మరోవారు.	మెగన్ మరియు హ్యారీ అనుభవిస్తున్న అమెరికాలోని జీవితం వారు ఆశించిన విధంగా ఉండలేదు అని మాజీ సిబ్బంది చెప్పారు.	మెఘాన్, హారీలు అమెరికాలో జీవితం వారు ఆశించినది కాదని భూత సిబ్బంది చెబుతున్నారు.
Elon Musk reacts to reports that he could be deported for immigration violation	అధికారులు: ఎలాన్ మస్క్ విమానావరణ లంకాంతర లేదా వివాదాన్ని కారణంగా ప్రమాణాలు ప్రకటించిన ప్రతిక్రియా వ్యక్తం చేస్తున్నారు.	ఎలాన్ మస్క్ గారు వలస నిబంధన ఉల్లంఘన కారణంగా దేశ నిర్బంధానికి గురవుతారనే వార్తలకు ప్రతిస్పందించారు.	ఎలాన్ మస్క్ వారు ఇమ్మిగ్రేషన్ ఉల్లంఘన కారణంగా వారిని దేశం నుండి తొలగించవచ్చునని వార్తలకు స్పందిస్తున్నారు.
How China is lessening its reliance on helium sourced from US	చైనా విడిచిన హిలియం మూలాల నుండి అన్యాయాధికారులకు అంశాలు తీసుకున్నది ఎలా అంటుంది?	చైనా ఎలా అమెరికా నుండి వచ్చే హీలియం పై ఆధారపడుతున్నదని తగ్గిస్తోంది.	చైనా యుఎస్ నుండి వచ్చే హీలియం మీద తన ఆధారాన్ని తగ్గిస్తున్నది.
Kindle Colorsoft owners complain of a yellow bar on the e-reader’s screen	కిండిల్ కలర్సాఫ్ట్ ఉద్యమ స్వామ్యలో అంకిత మూడి మేలు విడిపిస్తున్నారని అభిమానించేశారు.	Kindle Colorsoft యజమానులు ఈ-రీడర్ స్క్రీన్‌పై పసుపు గీత గురించి ఫిర్యాదు చేస్తున్నారు.	కిండిల్ కలర్సాఫ్ట్ యజమానులు ఈ-రీడర్ స్క్రీన్లో పసుపు బార్ గురించి ఫిర్యాదు చేస్తున్నారు.
Nvidia and its partners built a sophisticated system to bypass U.S. restrictions on exporting AI chips to the Middle East, Russia, and China.	న్విడియా మరియు అతన భాగస్వాములు మధ్య ప్రాంతాలకు, రష్యాకు మరియు చైనాకు యూ.ఎస్. పరిమితులను తాకడానికి ఉన్న AI చిప్లను నివారించడానికి ఒక ప్రముఖ వ్యవస్థను నిర్మించారు.	Nvidia మరియు వారి భాగస్వాములు మిడిల్ ఈస్ట్, రష్యా, చైనా దేశాలకు AI చిప్‌లను ఎగుమతి చేయడంపై అమెరికా పరిమితులను దాటేందుకు ఒక సాంకేతిక వ్యవస్థను నిర్మించారు.	న్విడియా మరియు వారి భాగస్వాములు యు.ఎస్. నిబంధనలను ఉల్లంఘించడానికి మధ్య ప్రాచ్యం, రష్యా, చైనాలకు ఎఐ చిప్స్ ఎగుమతి చేయడానికి ఒక సూక్ష్మ వ్యవస్థను నిర్మించారు.
The funding, which will top up the firm’s flagship fund, will be raised primarily from institutional investors. 	ఆ నిధులు, సంస్థాగత వినియోగదారుల నుండి ప్రధానంగా రూపొందించే ఫండును పూరించేందుకు ఇప్పటికే ప్రారంభించబోతుంది.	కంపెనీ ప్రధాన నిధికి అదనంగా వచ్చే ఈ నిధులను ప్రధానంగా సంస్థాగత పెట్టుబడిదారుల నుండి సేకరించబడతాయి.	ఆ సంస్థ యొక్క ప్రధాన నిధిని పూరించే ఆర్థిక సహాయం ప్రధానంగా సంస్థాగత పెట్టుబడిదారుల నుండి సేకరించబడుతుంది.
US Forest Service Decision to Halt Prescribed Burns in California is History Repeating	కేలిఫోర్నియాలో రాబడి బర్న్స్ నిలిపివేయడానికి US అటవీ సేవా నిర్ణయం చరిత్ర పునరావృతంలో ఉంది.	అమెరికా అటవీ సేవ యొక్క నిర్ణయం కాలిఫోర్నియాలో నియంత్రిత దహనాలను ఆపడానికి చరిత్ర పునరావృతమవుతున్నదనే విషయం.	అమెరికా అటవీ సేవా సంస్థలు కాలిఫోర్నియాలో నిర్దేశిత అగ్ని ప్రయోగాలను ఆపివేసే నిర్ణయం చరిత్ర పునరావృతం అవుతుంది.
The man who gave us the solution to the Entscheidungsproblem	మాకు ఎంత్సెయిడుంగ్స్ప్రాబ్లెం సమాధానం ఇచ్చిన వ్యక్తి	ఎన్‌షైడుంగ్స్‌ప్రాబ్లమ్‌కు పరిష్కారం ఇచ్చిన వ్యక్తి.	వారు మనకు ఎంట్స్చైడంగ్స్‌ప్రోబ్లెమ్ పరిష్కారం ఇచ్చిన వ్యక్తులు.
The shift in policy, covering government agencies and contractors working on national security, is intended to promote “responsible and ethical” innovations, the company said.	పొలిసులు మరియు మంత్రులు ముందుకు వచ్చిన నాస్యనల్ సెక్యూరిటీపై పని చేసే ప్రభుత్వ సంస్థలు మరియు కంట్రాక్టర్లపై నిర్బంధం మార్పు చేయడం కోసం, కంపెనీ చెబుతోంది అంటున్నారు.	"వారి కంపెనీ ప్రకారం, జాతీయ భద్రతపై పని చేసే ప్రభుత్వ సంస్థలు మరియు కాంట్రాక్టర్లను కవర్ చేసే విధాన మార్పు ""బాధ్యతాయుతమైన మరియు నైతిక"" ఆవిష్కరణలను ప్రోత్సహించడానికి ఉద్దేశించినది."	"ప్రభుత్వ సంస్థలు మరియు జాతీయ భద్రతా పనులలో పనిచేసే కాంట్రాక్టర్లను కవర్ చేసే విధాన మార్పు, ఆయా సంస్థలు ""బాధ్యతాయుతమైన మరియు నైతిక"" నూతన ఆవిష్కరణలను ప్రోత్సహించడానికి ఉద్దేశించబడింది, ఆ సంస్థ చెప్పింది."
China reveals a new heavy lift rocket that is a clone of SpaceX’s Starship	చైనా నూతన భారీ తడి రాకెట్ భారతీయ మొదలైన SpaceX స్టర్‌షిప్ కోపీయనను వెల్లడించింది.	చైనా కొత్త హెవీ లిఫ్ట్ రాకెట్‌ను ఆవిష్కరించారు, ఇది స్పేస్‌ఎక్స్‌ యొక్క స్టార్‌షిప్‌ యొక్క క్లోన్‌గా ఉంది.	చైనా అధికారులు స్పేస్‌ఎక్స్ యొక్క స్టార్‌షిప్ యొక్క క్లోన్ అయిన కొత్త భారీ ఎత్తు రాకెట్‌ను వెల్లడించారు.
Singapore requires vehicle owners to bid for a set number of Certificates of Entitlement – costly operating permits valid for only ten years.	సింగపూర్ వాహన యజమానులు మాత్రమే ప్రయాణ అనుమతులకు బిడ్ చేయాలని అగ్రహరణ ప్రమాణం కోసం – కేవలం పది ఏళ్ళ కేవలం చిరునామాలకు వినియోగం కోసం ఉన్నాయి.	సింగపూర్‌లో వాహన యజమానులు నిర్ణీత సంఖ్యలో ఎంటైటిల్‌మెంట్ సర్టిఫికెట్లు పొందడానికి బిడ్ చేయాల్సి ఉంటుంది, ఇవి కేవలం పదేళ్ల పాటు మాత్రమే చెల్లుబాటు అయ్యే ఖరీదైన ఆపరేటింగ్ అనుమతులు.	సింగపూర్ ప్రభుత్వాలు వాహన యజమానులకు పది సంవత్సరాల పాటు విలువైన నిర్వహణ పర్వేక్షణ పత్రాలను హారతి చేయడానికి అవసరం కలిగిస్తున్నాయి.
The Hwasong-19 is North Korea’s biggest missile yet and its test comes during a time of notable tensions on the peninsula.	హ్వాసాంగ్-19 ఉత్తర కొరియా యొక్క అత్యంత పెద్ద బాణం మరియు అతని ప్రయోగం కల్పనాకార్యాల సమయంలో అవగాహనాత్మక తాణాలును ఉంచేందో.	హ్వాసోంగ్-19 ఉత్తర కొరియాకు ఇప్పటివరకు అత్యంత పెద్ద క్షిపణి మరియు దాని పరీక్ష ద్వీపకల్పంలో ప్రస్తుత ఉల్లాస పరిస్థితుల సమయంలో జరిగింది.	హ్వాసాంగ్-19 ఉత్తర కొరియా యొక్క అతిపెద్ద క్షిపణి మరియు దాని పరీక్ష ద్వీపకల్పంలో గణనీయమైన ఉత్కంఠల సమయంలో జరుగుతుంది.
The species may have been carried to the Sacramento–San Joaquin Delta in ballast water on ships	ఈ జాతి అనువాదితంగా షిప్స్ పరికరాల బలాస్ట్ నీరులో సాక్రమెంటో-సాన్ జోకిన్ డెల్టకు దాటినట్టు ఉంటుంది.	ఆ జాతులు నౌకలలోని బల్లాస్ట్ నీటిలో సాక్రామెంటో-సాన్ జోక్విన్ డెల్టాకు తీసుకురాబడి ఉండవచ్చని మీరు అనుమానిస్తున్నారు.	జాతులు ఓడలపై బాలస్ట్ నీటిలో సాక్రమెంటో-సాన్ జోక్విన్ డెల్టాకు తీసుకువెళ్ళబడి ఉండవచ్చు.
Discovery partnered with PR firm Relevance International to produce ultra-luxury experiences and products under the banner of fictionaire billionaire Bruce Wayne’s conglomerate.	డిస్కవరీ పాలక ఫిర్మ్ రిలెవన్స్ అంటేర్నేషనల్ తో ఒక పక్షము చేసి, కథానాయకుడు బ్రూస్ వేన్ యొక్క సంఘమైన అంతావిశ్వసులను నిర్మించడానికి అదిరిపోయిన అనుభవములు మరియు ఉత్పన్నాలను తయారు చేయడానికి పాలకి ఉంది.	డిస్కవరీ వారు పిఆర్ సంస్థ రీలెవెన్స్ ఇంటర్నేషనల్‌తో భాగస్వామ్యం ఏర్పరచుకొని కల్పిత కోటీశ్వరుడు బ్రూస్ వేన్ యొక్క కాంగ్లోమెరేట్ పేరుతో అతి-ఆభరణీయ అనుభవాలు మరియు ఉత్పత్తులను తయారు చేయించారు.	డిస్కవరీ వారు రిలేవన్స్ ఇంటర్నేషనల్ అనే పీఆర్ సంస్థతో కలిసి ఫిక్షనైర్ బిలియనీర్ బ్రూస్ వేన్ వారి సంఘం యొక్క పతాకా క్రింద అత్యంత లాక్షరీ అనుభవాలు, ఉత్పత్తులను ఉత్పత్తి చేసారు.
Water utilities and chemical manufacturers are challenging the new EPA standards. 	నీరు యూటిలిటీస్ మరియు రసాయన నిర్మాతలు కొత్త EPA మానకాలను ప్రతిష్టించుకున్నారు.	జల సరఫరా సంస్థలు మరియు రసాయన తయారీదారులు కొత్త EPA ప్రమాణాలను సవాలు చేస్తూ ఉన్నారు.	నీటి సదుపాయాలు, రసాయన తయారీదారులు కొత్త ఇపిఎ ప్రమాణాలను సవాలు చేస్తున్నారు.
A radio station in Poland fired its on-air talent and brought in A.I.-generated presenters. An outcry over a purported chat with a Nobel laureate quickly ended that experiment.	పోలండ్ లో ఒక రేడియో స్టేషన్ తన ప్రసార సామర్థ్యాన్ని తనిఖీ చేశి, యాయింది ఐ.ఐ.-తయారు చేయబడిన ప్రస్తుతం. ఒక నోబెల్ లారియట్ తో అనిపించిన చాట్ పై ఒక అవాజు ఎగబడింది.	పోలాండ్‌లోని ఒక రేడియో స్టేషన్ వారి ఆన్-ఎయిర్ ప్రతిభను తొలగించి, ఏఐ-తో రూపొందించిన వ్యాఖ్యాతలను తీసుకువచ్చారు. ఒక నోబెల్ బహుమతి గ్రహీతతో జరిగినట్లు చెప్పిన సంభాషణపై వచ్చిన నిరసనతో ఆ ప్రయోగం త్వరగా ముగిసింది.	పోలండ్ లోని ఒక రేడియో స్టేషన్ తన ఆన్-ఎయిర్ ప్రతిభావంతులను తొలగించి, ఎయిఐ-జనరేటెడ్ ప్రజెంటర్లను తీసుకువచ్చింది. ఒక నోబెల్ లారియేట్ తో జరిగిన పుకారు చర్చకు త్వరగా ఆ ప్రయోగం ముగిసింది.
From infancy, children show heightened interest in events that are impossible or improbable, relative to likely events.	పుట్టినింటికి, పిల్లలు సాధ్యమైన లేదా అసాధ్యమైన సంగతులకు సంప్రేషణ చూపుకున్నారు.	శిశువు దశనుంచి, పిల్లలు సాధ్యమైన సంఘటనలతో పోల్చినప్పుడు అసాధ్యమైన లేదా అసంభావ్యమైన సంఘటనలపై ఎక్కువ ఆసక్తి చూపిస్తారు.	శిశువుల నుండి, వారు అసంభవమైన లేదా అప్రస్తుతమైన సంఘటనలపై సాధారణ సంఘటనల కంటే ఎక్కువ ఆసక్తిని ప్రదర్శిస్తారు.
Four persons were referred to hospital and the rest were treated as outpatients at the event venue, police sources said.	పోలీసుల మూలం నాలుగూరు వ్యక్తులు ఆసుపత్రికి నిలిపించబడ్డారు మరియు మిగిలినవి చికిత్స సమయంలో ఔట్‌పేషెంట్స్‌గా చికిత్స పొందడం చెప్పింది.	నాలుగు మంది వ్యక్తులను దవాఖానకు పంపించగా, మిగతావారిని ఈవెంట్ ప్రాంగణంలోనే అవుట్‌పేషెంట్లుగా చికిత్స చేశారు అని పోలీస్ వర్గాలు పేర్కొన్నాయి.	నలుగురు ఆసుపత్రికి పంపబడ్డారు, మిగిలిన వారు ఈవెంట్ వేదికపై అవుట్ పేషెంట్లుగా చికిత్స పొందారు, పోలీసు సూత్రాలు చెప్పాయి.
During investigation, the Washermenpet police found that he was attacked by three persons with stones and beer bottles while he was consuming alcohol.	చర్చలో, వాష్మేన్పేట్ పోలీసులు ఆతను ఆల్కహాల్ తాగతాడులోని సమయంలో మూడు వ్యక్తులు పథ్థరాలు మరియు బీరు బాటల్లతో ఆక్రమించారని కనుగొన్నారు.	దర్యాప్తు సమయంలో, వాషర్‌మెన్‌పేట్ పోలీసులు తెలుసుకున్నారు कि మూడు వ్యక్తులు అతని మీద రాళ్లు మరియు బీర్ బాటిళ్లతో దాడి చేసారని అతను మద్యం సేవిస్తున్నప్పుడు.	దర్యాప్తు సమయంలో, వాషర్మెన్‌పేట్ పోలీసులు అతను మూడు వ్యక్తులచే రాళ్ళు, బీరు సీసాలతో దాడి చేయబడినట్లు, అతను మద్యం సేవిస్తున్న సమయంలో కనుగొన్నారు.
Two juvenile boys who were lodged at the Government Observation Home in Chengalpattu escaped on Tuesday night.	చిన్నపిల్లలు రెండు మంది, మంగళవారం రాత్రి చెంగల్పట్టులో ప్రభుత్వ పరివీక్షణ హోమ్‌లో ఉన్నారు, అతను నిరాకరించబడ్డారు.	చెంగల్పట్టు ప్రభుత్వ పరిశీలన గృహంలో ఉంచబడిన ఇద్దరు కিশోర బాలురు మంగళవారం రాత్రి పారిపోయారు.	చెంగల్పట్టులోని ప్రభుత్వ పరిశీలన ఇల్లులో బస చేయబడిన ఇద్దరు కిషోరులు మంగళవారం రాత్రి తప్పించుకున్నారు.
During Mr. Gandhi’s Srinagar stay, men disembarked from cars on Boulevard road to hug him.	గాంధీ జీవితంలో శ్రీనగర్ ప్రవాసంలో, అదిపై కారులో నుండి ఆడండి భూలూవారీ రోడ్ పైన నిగ్రహించడానికి ఆధారంగా వ్యక్తులు ఉన్నారు.	గాంధీ గారి శ్రీనగర్ పర్యటన సమయంలో, బౌలేవార్డ్ రోడ్డుపై కార్ల నుండి దిగిన వ్యక్తులు ఆయనను ఆలింగనం చేసుకున్నారు.	శ్రీ గాంధీ గారు శ్రీనగర్ లో ఉన్న సమయంలో, వారు బులేవార్డ్ రోడ్ పై కార్ల నుండి దిగి వారిని కౌగలించుకున్నారు.
They alleged that several brick kilns started selling old stocks of bricks from Wednesday after paying the first instalment of the fine levied on them by the Geology and Mining Department.	వారు అనేక ఈట కిల్నులు గరువు దరఖాస్తు తీసుకునే తరువాత ముందుగా అవారానికి విచారణ చేసే కార్యాగారం కట్టిన ధరలు చెల్లుకున్న తరువాత కలవారు పున్యపు పురాతన స్టాక్స్ అమ్ముకొన్నారని ఆరోపించారు.	వారు ఆరోపించారు कि పులరంగు మరియు మైనింగ్ శాఖ వారి మీద విధించిన జరిమానా యొక్క తొలి విడత చెల్లించిన తరువాత, బుధవారం నుండి అనేక ఇటుక బట్టీలు పాత నిల్వల ఇటుకలను అమ్మడం ప్రారంభించారని.	వారు ఆరోపించారు కి బుధవారం నుండి వారిపై భూగర్భ శాఖ, గనుల శాఖ విధించిన జరిమానా మొదటి విడత చెల్లించిన తర్వాత అనేక ఇటుక కిల్నులు పాత స్టాకులను అమ్మడం ప్రారంభించాయి.
Ten Indian career diplomats, who are High Commissioners or Ambassadors of India in other countries, called on Governor R.N. Ravi at the Raj Bhavan in Chennai on Monday.	భారత దేశంలో ఇతర దేశాలలో హై కమిషనర్లు లేక రాష్ట్రాధ్యక్షులవర్గంలోని 10 భారత ఉచ్చ దూతులు మంగళవారం రాజభవనంలో గవర్నర్ ఆర్.ఎన్. రవిని కలిసినరు.	సోమవారం చెన్నైలోని రాజ్ భవన్‌లో గవర్నర్ ఆర్.ఎన్. రవిని కలిసిన పది మంది భారతీయ దౌత్యవేత్తలు, వీరు ఇతర దేశాలలో భారతదేశ హై కమిషనర్లు లేదా రాయబారులుగా ఉన్నారు.	భారత దేశానికి చెందిన పది మంది కెరీర్ దూతలు, ఇతర దేశాలలో భారత హై కమీషనర్లు లేదా రాయబారులు, సోమవారం చెన్నైలోని రాజ్ భవన్ లో గవర్నర్ ఆర్.ఎన్. రవి గార్లను కలుసుకున్నారు.
However, Dr. Hande, who wrote the foreword for her book and took part in some of these Assembly debates, says Muthu discharged her duty efficiently as a Minister with no room for corruption.	కానీ, తన పుస్తకంకు అనువాదం రాసిన డాక్టర్ హందే మరియు ఈ సభల వివాదాలలో కొన్నిని చేస్తున్న ముత్తుని గురించి మినిస్టర్గా తన కర్తవ్యాన్ని ఆదరణీయంగా నిర్వహించిందని హేల్ది గుర్తుంది.	అయితే, ఆమె పుస్తకానికి ముందుమాట రాసిన డాక్టర్ హాండే గారు మరియు కొన్ని అసెంబ్లీ చర్చల్లో పాల్గొన్నారు, ముత్తు గారు అవినీతికి తావు లేకుండా సమర్థవంతంగా మంత్రిగా తమ బాధ్యతను నిర్వహించారని అంటున్నారు.	అయితే, ఆమె పుస్తకానికి ముందుమాట వ్రాసిన డాక్టర్ హండేలు, ఆ అసెంబ్లీ చర్చల్లో కొన్నింటిలో పాల్గొన్నారు, ముఖ్యమంత్రులు అయిన ముత్తు తన బాధ్యతను సమర్థవంతంగా నిర్వహించారు, అక్రమాస్కాండలకు ఎటువంటి స్థలం లేదు.
While both Mr. Lobo and Mr. Kamat have cited disaffection with the Congress high command as reasons, the true reasons are all too transparent.	శ్రీమంతులు లోబో మరియు కామట్ గారు ఎల్లాంటి తోషాకరమైన కారణాలను నిర్దిష్టించడానికి కాంగ్రెస్ హై కమాండ్ నుండి తీరికవుంచిన నిజమేనని ఆధ్వానం చేస్తున్నారు.	శ్రీ లోబో గారూ మరియు శ్రీ కామత్ గారూ కాంగ్రెస్ ఉన్నతాధికారులతో అసంతృప్తిని కారణాలుగా పేర్కొన్నప్పటికీ, నిజమైన కారణాలు చాలా స్పష్టంగా ఉన్నాయి.	వారు రెండు కాంగ్రెస్ హై కమాండ్ తో అసంతృప్తిని కారణాలుగా పేర్కొన్నారు, కానీ నిజమైన కారణాలు చాలా స్పష్టంగా ఉన్నాయి.
The first festival celebrating the linguistic and cultural ties between the Barak Valley region of Assam and the Sylhet segment of Bangladesh began on Friday evening.	అస్సామ్ బారక్ వ్యాలీ ప్రాంతం మరియు బాంగ్లాదేశ్ సిల్హెట్ విభాగం లగింగ్విస్టిక్ మరియు సాంస్కృతిక సంబంధాలను జయించే మొదటి సందర్భం శుక్రవారం రాత్రి ప్రారంభం అయింది.	ఆసాం రాష్ట్రంలోని బరాక్ వ్యాలీ ప్రాంతం మరియు బంగ్లాదేశ్ లోని సిల్హెట్ భాగం మధ్య భాషాత్మక మరియు సాంస్కృతిక బంధాలను జరుపుకుంటూ మొదటి ఉత్సవం శుక్రవారం సాయంత్రం ప్రారంభమైంది.	ఆంధ్రప్రదేశ్ లోని బారక్ వ్యాలీ ప్రాంతం మరియు బంగ్లాదేశ్ లోని సిల్హెట్ విభాగం మధ్య భాషా సాంస్కృతిక బంధాలను సంతోషంగా జరుపుకునే మొదటి ఉత్సవం శుక్రవారం సాయంత్రం ప్రారంభమైంది.
The objective of such markets is to incentivise investments in renewable energy sources.	అంతకాలిక విపణుల లక్ష్యం రెన్యూయబుల్ ఎనర్జీ మూలాలలో పెట్టుబడి చేయడానికి ప్రేరేపించేవి ఉంది.	అటువంటి మార్కెట్ల లక్ష్యం పునరుత్పాదక ఇంధన వనరులలో పెట్టుబడులను ప్రోత్సహించడం.	ఆ మార్కెట్ల లక్ష్యం పునరుత్పాదక శక్తి వనరులలో పెట్టుబడులను ప్రోత్సహించడం.
The Centre is expected to clarify, later this year, the specifics of a carbon trading market in India.	కేంద్రం భవిష్యత్తులో, భారతదేశంలో కార్బన్ ట్రేడింగ్ మార్కెట్ యొక్క వివరాలను స్పష్టపరచడానికి అంతర్గతంగా తెలియజేస్తుందని ఆశిస్తున్నారు.	కేంద్రం ఈ సంవత్సరాంతంలో భారతదేశంలో కార్బన్ ట్రేడింగ్ మార్కెట్ యొక్క ప్రత్యేకతలను స్పష్టతచెప్పవలసిన అవసరం ఉందని భావిస్తున్నారు.	కేంద్రాలు ఈ సంవత్సరం చివరిలో భారతదేశంలో కార్బన్ ట్రేడింగ్ మార్కెట్ యొక్క వివరాలను స్పష్టం చేయబోతున్నాయి.
Hydrogen is an essential industrial fuel that has a range of uses from producing ammonia.	హైడ్రజన్ అమూల్యమైన ఔద్యోగిక ఇంధనం మరియు అమ్మోనియను తయారు చేయడానికి ఉపయోగించే వివిధ ఉపయోగాల కి ఉపయోగపడేది.	హైడ్రోజన్ అనేది అమోనియాను ఉత్పత్తి చేయడం నుంచి మొదలై అనేక వినియోగాల కోసం ఉపయోగించే ఒక ముఖ్యమైన పారిశ్రామిక ఇంధనం.	హైడ్రోజన్ అనేది వివిధ ఉపయోగాలను కలిగి ఉన్న ఒక అవసరమైన పారిశ్రామిక ఇంధనం, అమోనియా ఉత్పత్తి చేయడం నుండి.
Finance Minister Nirmala Sitharaman on Saturday said that regulators would do their job.	ఆదివారం ఆర్థిక మంత్రి నిర్మల సీతారామన్ పేర్కొన్నారు మార్గదర్శకులు తమ పని చేస్తుంటారని చెప్పారు.	ఆర్థిక మంత్రి నిర్మలా సీతారామన్గారు శనివారం నాడు నియంత్రణాధికారులు తమ విధిని నిర్వహిస్తారని అన్నారు.	ఆర్థిక మంత్రులు నిర్మలా సీతారామన్ శనివారం చెప్పారు అయితే రెగ్యులేటర్లు వారి పని చేస్తారు.
Madras has received a grant of ₹242 crore to do research on laboratory-grown diamonds.	మద్రాసులు ప్రయోగశాలలో వళ్లు గోల్డెన్ డెయిమండ్ల ప్రయోగాల పరిశోధనకు ₹242 కోట్లు అనుదానం పొందింది.	మద్రాస్‌కు ప్రయోగశాలలో పెంచిన వజ్రాల పరిశోధన చేయడానికి ₹242 కోట్ల మంజూరు లభించింది.	మద్రాస్ వారు ₹242 కోట్ల గ్రాంట్ పొంది లాబొరేటరీ-పెంచిన వజ్రాల పరిశోధనకు చేయనున్నారు.
Before Rao took leave after the meeting, MGR gently reminded him of the Cauvery water.	మీరు సభలో భేటీ తరువాత విముక్తి తీసుకున్న ముంగిసి రావులు, ఎమ్జీఆర్ అతనిని కావేరి నీరు గురించి మృదువుగా గుర్తుంది.	రావు గారు సమావేశం తర్వాత సెలవు తీసుకునే ముందు, ఎం.జి.ఆర్ గారు కృష్ణా నీటి గురించి సున్నితంగా గుర్తు చేశారు.	రావు సమావేశం తర్వాత సెలవు తీసుకునే ముందు, ఎంజీఆర్ వారు ఆయనకు కావేరి నీటి గురించి మెల్లగా గుర్తు చేశారు.
It is because of this initiative that Tamil Nadu became the centre of higher learning.	ఇది ఈ ప్రయత్నం వలన తమిళనాడు అధ్యయనాల కేంద్రం అయ్యింది.	ఈ కార్యక్రమం వల్లే తమిళనాడు ఉన్నత విద్యా కేంద్రంగా మారింది.	ఈ ఉద్యమం వల్ల తమిళనాడు ఉన్నత విద్యా కేంద్రంగా అయింది.
However, within minutes after the then Prime Minister intervened.	కానీ, అంతక్కు స్థాయి ప్రధాని పడిన తరువాత క్షణాల్లో అవాక్కాయి.	అయితే, అప్పటి ప్రధాన మంత్రులు జోక్యం చేసుకున్న కొద్ది నిమిషాల తరువాత.	అయితే, అప్పటి ప్రధాన మంత్రులు హస్తక్షేపం చేసిన కొద్ది నిమిషాల్లోనే.
The initial shock following the Taliban’s seizure of power in Kabul is waning.	కాబుల్‌లో టాలిబాన్ శక్తి కొరకు తదుపరితాపం క్రిందకు పడుతోంది.	కాబూల్‌లో తాలిబాన్ అధికారం చేజిక్కించుకున్న తర్వాత వచ్చిన ప్రాథమిక షాక్ తగ్గిపోతుంది.	కాబుల్లో తాలిబాన్ల అధికారం స్వీకరణ తరువాత మొదటి ఆఘాతం తగ్గిపోతోంది.
The greatest impact of denial of rights for women in the workforce would be a sharp contraction in the economy.	స్త్రీలకు హక్కుల నిరాకరణ ప్రభావం వర్క్ ఫోర్స్లో స్త్రీలకు విరుద్ధంగా కలిగిన ప్రభావం అత్యంత ముఖ్యం.	ఉద్యోగ రంగంలో మహిళలకు హక్కుల నిరాకరణ యొక్క భారీ ప్రభావం ఆర్థిక వ్యవస్థలో తీవ్రమైన క్షీణతగా ఉంటుంది.	స్త్రీలకు ఉద్యోగ రంగంలో హక్కుల నిరాకరణ యొక్క అత్యధిక ప్రభావం ఆర్థిక వ్యవస్థలో తీవ్రమైన సంకోచం అవుతుంది.
The Taliban do not shy from leveraging the issue to gain international attention.	టాలిబాన్ అంతర్జాతీయ ప్రముఖతని పొందడానికి విషయాన్ని ఉపయోగించడంలో థలిబాన్ విముఖంగా ఉంటారు.	తాలిబాన్ అంతర్జాతీయ దృష్టిని పొందడానికి ఈ విషయంలో ప్రయోజనం పొందడానికి వెనుకాడరు.	తాలిబాన్ వారు అంతర్జాతీయ శ్రద్ధను పొందడానికి ఈ సమస్యను ఉపయోగించుకోవడానికి సిగ్గుపడరు.
In Jammu and Kashmir, the enrolment dropped sharply from 1.78 lakh in 2019-20 to 1.31 lakh in 2020-21.	జమ్ము మరియు కాశ్మీర్ లో, 2019-20 లో 1.78 లక్షల నుండి 2020-21 లో 1.31 లక్షల వరకు ఏకదేశం తగిన చేసింది.	జమ్మూ మరియు కశ్మీర్‌లో, నమోదు 2019-20 లో 1.78 లక్షల నుండి 2020-21 లో 1.31 లక్షల వరకు గణనీయంగా తగ్గింది.	జమ్ము కాశ్మీర్ లో, వారు 2019-20 లో 1.78 లక్షలకు నుండి 2020-21 లో 1.31 లక్షలకు నమోదు తీవ్రంగా తగ్గింది.
Senior advocate Meenakshi Arora made the oral mentioning for early hearing.	వరిష్ఠ సలహాదారుడు మీనాక్షి అరోరా త్వరలో విచారణ కోసం వాక్య చేయడానికి మోసంచేసింది.	సీనియర్ అడ్వకేట్ మీనాక్షి అరోరా గారు ముందస్తు విచారణ కోసం మౌఖికంగా ప్రస్తావించారు.	సీనియర్ అడ్వొకేట్లు మీనాక్షి ఆరోరా గారు ఆరంభ విన్నపం కోసం మౌఖిక ప్రస్తావన చేశారు.
The State had never forced students out of State schools by restricting hijab.	రాష్ట్రం ఎవరినీ హిజాబ్ పరిమితం చేసినట్లు రాష్ట్ర పాఠశాలలు నుంచి విద్యార్థులను బహిష్కరించలేదు.	రాష్ట్ర ప్రభుత్వం హిజాబ్ పరిమితం చేయడం ద్వారా విద్యార్థులను ప్రభుత్వ పాఠశాలల నుంచి బయటికి పంపించిన సందర్భం ఎప్పుడూ లేదు.	రాష్ట్రాలు ఎప్పుడూ హిజాబ్ పరిమితులను ఆంశికంగా రాష్ట్ర పాఠశాలల నుండి విద్యార్థులను బహిష్కరించలేదు.
The patient has the right to refuse to participate in such research projects.	రోగికి అందరూ ఆ సంశోధన ప్రాజెక్టులలో పాల్గొనడానికి హక్కు ఉంది.	రోగి అలాంటి పరిశోధన ప్రాజెక్టులలో పాల్గొనడానికి నిరాకరించే హక్కును కలిగి ఉంటారు.	రోగులు ఆ విధమైన పరిశోధనా ప్రాజెక్టుల్లో పాల్గొనడానికి నిరాకరించే హక్కు కలిగి ఉన్నారు.
The field officials should remember it while implementing projects. 	కార్యకలాపాలను అమలు చేస్తూ క్షేత్ర అధికారులు దానిని గుర్తుపడాలి.	ప్రాజెక్టులను అమలు చేస్తూ ఉన్నప్పుడు ఈ విషయాన్ని గుర్తుంచుకోవాలని మీరందరూ క్షేత్రాధికారులు గౌరవపూర్వకంగా దయచేసి గుర్తించాలి.	ప్రాంతీయ అధికారులు ప్రాజెక్టులను అమలు చేసేటప్పుడు దీన్ని గుర్తుంచుకోవాలి.
Senior officials in the Ministry of Tribal Affairs said a change in the structure had already been approved.	జాతీయ ప్రభుత్వ కార్యాలయంలో ప్రధాన అధికారులు ఒక నిర్ధారణ అనుమోదించబడిందని ప్రధానాధికారులు చెప్పారు.	గిరిజన విషయాల మంత్రిత్వ శాఖలోని సీనియర్ అధికారులు చెప్పినది ఏమిటంటే, నిర్మాణంలో మార్పు ఇప్పటికే ఆమోదించబడింది.	ఆదివాసీ వ్యవహారాల మంత్రిత్వ శాఖలోని ఉన్నతాధికారులు ఒక నిర్మాణ మార్పును ఇప్పటికే ఆమోదించారు.
The Bhagwan Mahaveer Foundation has called for applications for the Mahaveer awards.	భగవాన్ మహావీర్ ఫౌండేషన్ మహావీర్ పురస్కారాలకు దరఖాస్తులు కోసం పిలుస్తోంది.	భగవాన్ మహావీర్ ఫౌండేషన్ మహావీర్ అవార్డుల కోసం దరఖాస్తులను ఆహ్వానించారు.	భగవాన్ మహావీర్ ఫౌండేషన్ వారు మహావీర్ అవార్డులకు దరఖాస్తులు కోరుతున్నారు.
Mr. Yediyurappa resigned as Chief Minister and was succeeded by Basavaraj Bommai in 2020.	శ్రీ యెడియూరప్ప ముఖ్యమంత్రిగా రాజీనామా చేసి, 2020లో బసవరాజ్ బొమ్మయి అధికారం ప్రాప్తి చేసాడు.	యెడియూరప్ప గారు ముఖ్యమంత్రిగా రాజీనామా చేసి, 2020 లో బసవరాజ్ బొమ్మై గారు వారిని అనుసరించారు.	శ్రీ యేడియూరప్ప గారు ముఖ్యమంత్రులుగా రాజీనామా చేసి, బసవరాజ్ బొమ్మాయి గారు వారి స్థానంలో వచ్చారు 2020లో.
The rescuers had to cut the roof of the lift to bring them out, and nobody was hurt.	రక్షకులు వాహనం నుండి వాల్టుని తొడిపారు, మరియు ఎవరూ గుర్తుపడలేదు.	రక్షకులు వారిని బయటకు తీసుకురావడానికి లిఫ్ట్ పైకప్పును కత్తిరించవలసి వచ్చింది, మరియు ఎవరికీ గాయాలు కాలేదు.	రక్షకులు వారిని బయటకు తీసుకురావడానికి ఎలివేటర్ పైకప్పు కోయడానికి వారు నిర్భయంగా ఉన్నారు.
The group claimed another police station attack in Rask that killed one officer on January 10.	జనాభివృద్ధి జనం ఒక పోలీసు స్టేషన్ దాడిని దాదాపోయిన, జనవరి 10న రాస్క్లో మరో పోలీసు స్టేషన్ దాడి వారిని చంపించింది.	రాస్క్‌లో జనవరి 10న ఒక అధికారి మరణించిన పోలీస్‌స్టేషన్‌ దాడిని ఆ గుంపు మరోసారి ప్రకటించుకున్నారు.	ఆ సమూహం జనవరి 10న రాస్క్ లో మరో పోలీస్ స్టేషన్ దాడిని ప్రకటించింది, దాంతో ఒక అధికారి మరణించారు.
Based on the complaint, an FIR has been registered against Constable Shailendra Singh and three other policemen.	ప్రమాణం ప్రకటన ప్రకారం, కాన్స్టేబుల్ షైలేంద్ర్ సింగ్ మరియు మూడు ఇతర పోలీసులకు వేదిక నమోదు చేయబడింది.	ఫిర్యాదు ఆధారంగా, కానిస్టేబుల్ శైలేంద్ర సింగ్ మరియు మరి మూడు మంది పోలీసులపై ఎఫ్ఐఆర్ నమోదు చేయబడింది.	ఫిర్యాదు ఆధారంగా, కానిస్టేబుల్ శైలేంద్ర సింగ్ మరియు ఇతర పోలీసులకు వ్యాజాలు నమోదు చేయబడ్డాయి.
Financial institutions also play a crucial role in tracking the money trails sustaining these networks.	ఆర్థిక సంస్థలు ఈ నెట్వర్కులను భద్రతగా ఉంచే డబ్బు పథాలను ట్రాక్ చేయడంలో కూడా ప్రముఖ పాత్రం ప్లే చేస్తాయి.	ఆర్థిక సంస్థలు ఈ నెట్‌వర్క్‌లను కొనసాగిస్తున్న డబ్బు మార్గాలను గుర్తించడంలో కూడా ముఖ్యమైన పాత్ర పోషిస్తారు.	ఆర్థిక సంస్థలు కూడా ఈ నెట్వర్కులను సమర్థిస్తున్న డబ్బు మార్గాలను పరిశీలించడంలో కీలక పాత్ర పోషిస్తున్నాయి.
It is laudable that customs duties have been waived on three anti-cancer drugs.	మూడు వ్యాధినివారక ఔషధాలకు కస్టమ్స్ ఛందాలు విడ్డండినట్లు గౌరవాన్వితంగా ఉంది.	మూడు క్యాన్సర్ నిరోధక ఔషధాలపై కస్టమ్స్ సుంకాలు రద్దు చేయబడినందుకు మీకు అభినందనలు.	ఆయా అధికారులు మూడు కేన్సర్ వ్యాధి నివారణ మందులపై సరుకు సుంకాలను రద్దు చేసినందుకు అభినందనీయం.
Inside the final sprint in the biggest battleground state on the map.	నక్షాలో అత్యంత ప్రధాన యుద్ధ రాజ్యంలో చివరకు ఉన్న చివరలో లోపల ఉండి.	పటం మీద అత్యంత పెద్ద పోరాట రంగ రాష్ట్రంలో చివరి దశలో ఉన్నారు.	అతిపెద్ద యుద్ధరంగంలో చివరి స్ప్రింట్ లోపల.
All eyes are on America as an uncertain world awaits election result.	ప్రతిష్ఠాత్మకులు అమెరికా పై అక్షరాలే ఉన్నాయి, అనిశ్చితంగా ఉద్యానం ఎక్కువగా ఎదురుచూస్తున్నది.	అస్పష్ట ప్రపంచం ఎన్నికల ఫలితాల కోసం వేచిచూస్తుండగా, అన్ని కళ్ళు అమెరికాపై ఉన్నాయి.	అన్ని కళ్ళు అమెరికాపై ఉండగా, అనిశ్చిత ప్రపంచం ఎన్నికల ఫలితాన్ని ఎదురుచున్నది.
Twitch faces criticism over Israel-Gaza war content on platform.	ప్రదేశం మీద ఇస్రాయెల్-గాజా యుద్ధ కాంటెంట్ పై ట్విచ్ నుండి తీవ్రంగా విమర్శ చేస్తున్నారు.	ట్విచ్ ప్లాట్‌ఫారమ్‌పై ఇజ్రాయిల్-గాజా యుద్ధ కంటెంట్‌కు సంబంధించి విమర్శలు ఎదుర్కొంటున్నారు.	ట్విచ్ వ్యవస్థ ఇస్రాయెల్-గాజా యుద్ధ సంబంధిత విషయాలపై విమర్శలను ఎదుర్కొంటున్నది.
North Korea fires multiple ballistic missiles toward the sea ahead of U.S. election.	ఉత్తర కొరియా యు.ఎస్. ఎన్నికల ముందు సముద్రంకు వేరు బాలిస్టిక్ మిసైల్లు చేపట్టుతుంది.	ఉత్తర కొరియా యుఎస్ ఎన్నికల ముందు సముద్రం వైపుగా అనేక బ్యాలిస్టిక్ క్షిపణులను ప్రయోగించుచున్నారు.	ఉత్తర కొరియా అధికారులు అమెరికా ఎన్నికల ముందు సముద్రం వైపు బహుళ బాలిస్టిక్ క్షిపణులను ప్రయోగించారు.
Singapore Airlines will add first class, revamp cabins for longest flights.	సింగపూరు ఎయిర్లైన్స్ అత్యంత దీర్ఘమైన ప్రయాణాలకు మొదటి క్లాస్ చేర్చి, క్యాబిన్లను రీవాంప్ చేస్తుంది.	సింగపూర్ ఎయిర్‌లైన్స్ గౌరవనీయులైన మీకు తెలియజేయగోరుతున్నాము, వారు తమ అతి దీర్ఘ ప్రయాణాలకు ఫస్ట్ క్లాస్‌ను జోడించడం మరియు కేబిన్లను పునర్నిర్మించడం చేయనున్నారు.	సింగపూర్ ఎయిర్లైన్స్ వారు ఫర్స్ట్ క్లాస్ ను జోడించి, అత్యంత పొడవైన ప్రయాణాల కొరకు కేబిన్లను పునర్వ్యవస్థీకరిస్తారు.
Priyanka Chopra Jonas and Nick Jonas celebrate 'Diwaloween,' Diwali and Halloween mashup.	ప్రియంకా చోప్రా జోనాస్ మరియు నిక్ జోనాస్ 'దివాలోవీన్' జరుపుకుందాం, దీపావళి మరియు హాలోవీన్ మాషప్.	ప్రియాంకా చోప్రా జోనాస్ మరియు నిక్ జోనాస్ 'దివాలోయీన్,' దీపావళి మరియు హాలోవీన్ మిళితోత్సవాన్ని జరుపుకుంటున్నారు.	ప్రియాంక చోప్రా జోనాస్ మరియు నిక్ జోనాస్ వారు 'దీవాలోవీన్' జరుపుకుంటున్నారు, దీపావళి మరియు హాలోవీన్ మిశ్రమం.
Pennsylvania officials denounce Halloween float appearing to depict Harris tied to golf cart.	పెన్సిల్వేనియా అధికారులు హ్యాలోవీన్ ప్రమాణానికి దారిలో ఉన్న హ్యారిస్ను గోల్ఫ్ కార్ట్లో బంధించడం అనుకరించుకుంది.	పెన్సిల్వేనియా అధికారులు హారిస్‌ను గోల్ఫ్ కార్ట్‌కు కట్టినట్లు చూపించే హాలోవీన్ ఫ్లోట్‌ను ఖండించారు.	పెన్సిల్వేనియా అధికారులు హాలోవీన్ ఫ్లోట్ హారిస్ గోల్ఫ్ కార్ట్లో బంధించబడినట్లు కనిపిస్తున్నదాన్ని ఖండిస్తున్నారు.
Elon Musk's election-doubting posts shared 9 times more than his less extreme election content.	ఎలాన్ మస్క్ చేసిన అంచనా దృఢ పోస్టులు తన తక్కువ అంచనా విషయాలను మీరు పంచుకున్నారు.	ఎలాన్ మస్క్ గారి ఎన్నికలపై సందేహం వ్యక్తం చేసే పోస్టులు, ఆయన తక్కువ తీవ్రత కలిగిన ఎన్నికల విషయక కంటెంట్ కంటే 9 రెట్లు ఎక్కువగా పంచుకున్నారు.	ఎలాన్ మస్క్ గారు ఎన్నికలపై సందేహాలు వ్యక్తీకరించే పోస్టులు వారి తక్కువ అతివాద ఎన్నిక సంబంధ విషయాలకు 9 రెట్లు ఎక్కువగా పంచుకున్నాయి.
Americans eye the economy from kitchen tables and hourly jobs as they plan their votes.	అమెరికావాసులు తమ ఓటులను నియోజకాలను ప్రణాళీ కట్టబోతున్నారు. వ్యవసాయాలు నుండి, కార్యకలాపాలు నుండి అమెరికావాసులు ఆర్థిక స్థితిని అందించే విధంగా చూస్తున్నారు.	అమెరికన్లు తమ ఓట్లను ప్లాన్ చేసుకుంటూ, వంటగదుల పట్టికల దగ్గర నుండి మరియు గంటకొకసారి చేసే ఉద్యోగాల నుండి ఆర్థిక వ్యవస్థను పరిశీలిస్తున్నారు.	అమెరికన్లు వారి ఓట్లను ప్లాన్ చేసేటప్పుడు వారు కిచెన్ టేబుల్స్ నుండి ఆర్థిక వ్యవస్థను పరిశీలిస్తున్నారు మరియు ప్రతి గంట ఉద్యోగాల నుండి.
Quincy Jones, musical maestro and entertainment industry titan, dies at 91.	క్విన్సీ జోన్స్, సంగీత మహామాహితి మరియు వినోద పరిశ్రమ మహాసమ్రాటు, 91 ఏళ్ళున మృతి పొందారు.	క్విన్సీ జోన్స్, సంగీత మాంత్రికుడు మరియు వినోద పరిశ్రమ దిగ్గజం, 91 సంవత్సరాల వయస్సులో మృతి చెందారు.	క్విన్సీ జోన్స్, సంగీత విద్వాంసులు మరియు వినోద పరిశ్రమ దిగ్గజాలు, 91 వ ఏట మరణించారు.
Proud Boys claim they'll be at polling places as Trump ups violent rhetoric and fraud claims	ప్రౌడ్ బాయ్స్ అభిమానిస్తున్నారు మరియు ట్రంప్ సహసాంగమ ప్రవాదానికి మరియు ఫ్రడ్ దావాలను ఎదుగుదారు అంటున్నారు ఎందుకంటే పోలింగ్ ప్లేస్‌లలో ఉంటారని ప్రమాణిస్తున్నారు.	"గౌరవనీయులైన అధికారులకు సంబోధించే సందర్భంలో, తెలుగు భాషలో సమ్మానార్థక plurals ఉపయోగించి ఈ వాక్యం అనువదించండి: ""ప్రౌడ్ బాయ్స్ తమను పోలింగ్ కేంద్రాలలో ఉంటామని చెప్పుకుంటున్నారు, అటువంటి సమయంలో ట్రంప్ గారు హింసాత్మక భాషను మరియు మోసపు ఆరోపణలను పెంచుతున్నారు."""	ప్రౌడ్ బాయ్స్ అధికారులు వారు పోలింగ్ ప్లేసెస్ వద్ద ఉంటారని చెబుతున్నారు, ట్రంప్ హింసాత్మక భాషణను పెంచుతున్నారు, మోసం ఆరోపణలను చేస్తున్నారు.
One of the police officers stumbled to the ground when the driver applied brakes and attempted to strike him.	డ్రైవర్ బ్రేక్స్ చేసినప్పుడు పోలీసులలో ఒకరు గుర్తు పెట్టి భూమికి పడిపోయాడు.	ఒకరు డ్రైవర్ బ్రేకులు వేయగా, అతన్ని దాడి చేయడానికి ప్రయత్నించగా, పోలీసు అధికారులలో ఒకరు నేలపై పడిపోయారు.	ఒక పోలీసు అధికారులు డ్రైవరు బ్రేక్స్ అప్లై చేసి వారిని కొట్టడానికి ప్రయత్నించినప్పుడు నేలకు కూలిపోయారు.
The authorities confirmed they have identified the vehicle's owner and expect to make an arrest shortly.	ప్రభుత్వములు వాహనం యొక్క యజమానిని అంచనా చేసినట్లు మరియు తక్షణముగా ఒక గ్రహణం చేస్తున్నట్లు ఆశిస్తున్నారు.	అధికారులు వాహన యజమానిని గుర్తించినట్లు నిర్ధారించారు మరియు త్వరలో అరెస్టు చేస్తామని ఆశిస్తున్నారు.	అధికారులు వాహనం యజమానిని గుర్తించారు, త్వరలో అరెస్టు చేయడానికి ఆశిస్తున్నారు.
The Chhatrapati Shivaji statue in the Arabian Sea off the Mumbai coast is referred to as a precedent for the proposed pen memorial.	ముంబయి తీరంలో ఆరబియన్ సముద్రంలో ఉన్న ఛత్రపతి శివాజీ ప్రతిమ ప్రస్తావిత కల్పిత కలులు కోసం ఒక మూలానుభవంగా సూచిస్తున్నారు.	ముంబై తీరానికి సమీపంలోని అరేబియా సముద్రంలో ఉన్న ఛత్రపతి శివాజీ విగ్రహం ప్రతిపాదిత కలం స్మారక చిహ్నానికి ఒక మునుపటివారి ఉదాహరణగా పేర్కొనబడుతోంది.	ముంబై తీరం నుండి అరబ్బీ సముద్రంలో ఉన్న ఛత్రపతి శివాజీ విగ్రహం ప్రతిపాదిత కలం స్మారకానికి ముందుమార్గంగా పేర్కొనబడుతుంది.
Several political parties have opposed the pen memorial in the proposed location.	కొన్ని రాజకీయ పక్షాలు సూచించిన స్థలంలో పెన్ స్మారకాన్ని విరోధించాయి.	కొన్ని రాజకీయ పార్టీలు ప్రతిపాదిత ప్రాంతంలో కలము స్మారకాన్ని వ్యతిరేకించాయి.	అనేక రాజకీయ పార్టీలు ప్రతిపాదిత స్థలంలో కలం స్మారకాన్ని వ్యతిరేకించాయి.
They have not taken into consideration the rainfall data of 2015 or years thereafter. 	వారు 2015 లో లేదా అలాంకారం చేసే సంవత్సరాల వరకు వర్షాల డేటాను పరిగణించలేదు.	2015 లేదా ఆ తర్వాతి సంవత్సరాల వర్షపాతం డేటాను వారు పరిగణలోకి తీసుకోలేదు.	వారు 2015 లేదా ఆ తరువాతి సంవత్సరాల వర్షపాత డేటాను పరిగణనలోకి తీసుకోలేదు.
The museum has been equipped with multimedia content, QR codes and holograms.	ప్రాధమిక ఉపకరణాలతో, క్యూఆర్ కోడ్స్ మరియు హోలోగ్రామ్‌లతో మ్యూజియం సజీవగొచినది.	మ్యూజియం మల్టీమీడియా కంటెంట్, QR కోడ్స్ మరియు హోలోగ్రామ్లతో సజ్జమైంది.	వారు మ్యూజియం ను మల్టీమీడియా కంటెంట్, క్యూఆర్ కోడ్లు, హోలోగ్రామ్స్ తో సజ్జీకరించారు.
The ninth phase of the excavations would begin later this month, said officials.	అధికారులు చెప్పారు, ఈ నెల పారాయణ అభ్యాసాల తొస్స గుర్తించబోతుంది.	"""తవ్వకాల తొమ్మిదవ దశ ఈ నెల చివరిలో ప్రారంభం కానుందని అధికారులు తెలిపారు."""	ఈ నెలలో తరువాత ఉత్కావణాల తొమ్మిదవ దశ ప్రారంభం కానుంది, అధికారులు చెప్పారు.
Mr. Reddy is a close relative of Taraka Ratna's wife Alekya Reddy.	రెడ్డి సాహోదరులలో ఒకరు తారక రత్నా భార్య అలేఖ్య రెడ్డి సంబంధించిన సన్ని సంబంధమైనవాడు.	శ్రీ రెడ్డి గారు తరక రత్న గారి భార్య అలేఖ్య రెడ్డి గారి సన్నిహిత బంధువు.	రెడ్డి గారు తారక రత్న గారి భార్య ఆలేఖ్యా రెడ్డి గారికి సన్నిహితులు.
This betrays an inexplicable hostility towards knowledge creation of all kinds. 	ఇది అన్యాయాన్ని తెలియజేసే ప్రతి ప్రకారంలో జ్ఞాన సృష్టికి అసహ్యమైన వెనుకకు పోగొచ్చు.	ఇది అన్ని రకాల జ్ఞాన సృష్టి పట్ల ఒక అర్థం చేసుకోలేని వైరం చూపుతుంది.	ఇది అన్ని రకాల జ్ఞాన సృష్టికి విచారణీయమైన వైరుధ్యాన్ని ప్రదర్శిస్తుంది.
The second is what he calls alienation from the process of labour.	రెండవ వస్తువు అది అవను కూర్చే కార్య ప్రక్రియతో పరదార్థతనం అంటూ పిలువుతున్నాడు.	రెండవది ఆయన కూలీ ప్రక్రియ నుండి వేరుపాటు అని పిలుస్తారు.	రెండవది వారు కార్మిక ప్రక్రియ నుండి పరోపకారం అని పిలుస్తారు.
In the process, Marx argued, workers become miserable.	ప్రక్రియలో, మార్క్స్ వాదించినట్లు, కార్మికులు దుఃఖంగా భావిస్తారు.	దాని ప్రక్రియలో, మార్క్స్ వాదించినట్లు, కార్మికులు దయనీయ స్థితికి చేరుకుంటారు.	ఈ ప్రక్రియలో, మార్క్స్ వాదించారు, కార్మికులు దుఃఖితులైనారు.
He asked the people to compare the scale of development in the adjoining Assam during eight years of BJP rule.	ఆతను ప్రజలకు బీజేపీ ప్రభుత్వంలో ఎనిమిది సంవత్సరాల వరకు అసామ్లో ప్రగతి మీద తీసుకుని పరికల్పించాడు.	ఆయన ప్రజలను, ఎనిమిది సంవత్సరాల బీజేపీ పాలనలో పక్కనున్న అస్సాంలోని అభివృద్ధి పరిమాణాన్ని పోల్చమని కోరారు.	ఆయన వారు తొమ్మిది సంవత్సరాల భాజపా పాలనలో సమీప అస్సాంలో అభివృద్ధి స్థాయిని పోల్చమని ప్రజలను కోరారు.
The DMK MP also said that the Budget presented by Union Finance Minister Nirmala Sitharaman had neglected sectors such as education, health and agriculture.	డిఎంకే ఎంపీగా కూడా యూనియన్ ఫైనాన్స్ మంత్రి నిర్మల సీతారామన్ అంతర్జాతీయ బజెట్ ప్రారంభించడంలో పాఠశాల, ఆరోగ్య మరియు వ్యవసాయ విభాగాలను లేక నిలకలేదని కూడా చెబుతూ ఉండాడు.	DMK ఎంపీలు కూడా కేంద్ర ఆర్థిక మంత్రి నిర్మలా సీతారామన్ గారు సమర్పించిన బడ్జెట్ విద్య, ఆరోగ్యం, వ్యవసాయం వంటి రంగాలను నిర్లక్ష్యం చేశారని అన్నారు.	డీఎంకే ఎంపీ కూడా కేంద్ర ఆర్థిక మంత్రులు నిర్మలా సీతారామన్ వారు ప్రసాదించిన బడ్జెట్ విద్య, ఆరోగ్యం, వ్యవసాయం వంటి రంగాలను విస్మరించిందని చెప్పారు.
The accident took place around 3 p.m. on a State highway close to Korar village.	అపఘాతం ఉదయం 3 గంటలకు సమీపంలో ఒక రాష్ట్ర రహదారి మరియు కోరర్ గ్రామం సమీపంలో జరిగింది.	దుర్ఘటన సుమారు మూడింటికి రాష్ట్ర హైవేపై కొరార్ గ్రామం సమీపంలో చోటు చేసుకుంది.	ఆనుఘటన రాష్ట్ర రహదారిపై కొరారు గ్రామం సమీపంలో 3 గంటల సమయంలో జరిగింది.
Both the survivors are being treated at a hospital in Raipur.	రాయపురలో అమ్ముడులు రోగించినవి రాయపురలో ఒక ఆస్పత్రిలో చికిత్స పొందుతున్నారు.	రాయపూర్‌లోని ఒక ఆసుపత్రిలో ఆ ఇద్దరు సజీవంగా ఉన్నవారిని చికిత్స అందిస్తున్నారు.	రెండు బతికున్న వారు రాయపూర్ లోని ఒక ఆస్పత్రిలో చికిత్స పొందుతున్నారు.
Chief Minister Bhupesh Baghel took to Twitter to express grief over the accident.	ముఖ్యమంత్రి భూపేష్ బాఘేల్ ట్విట్టర్‌లో ప్రమాదం పై దు: ఖేదానికి వ్యక్తం చేసినారు.	ముఖ్యమంత్రి భూపేష్ బఘేల్ గారు ప్రమాదం పట్ల తన దుఃఖాన్ని వ్యక్తం చేయడానికి ట్విట్టర్‌ను ఆశ్రయించారు.	ముఖ్యమంత్రులు భూపేష్ బగేల్ ఆకస్మికం పట్ల సంతాపం వ్యక్తం చేయడానికి ట్విట్టర్‌ను ఉపయోగించారు.
The Indian Institute of Technology Madras (IIT-M) Research Park hosted a competition for children.	భారతీయ ఇన్స్టిట్యూట్ ఆఫ్ టెక్నాలజీ మద్రాస్ (IIT-M) రిసర్చ్ పార్క్ వారికి కూటుపోటు నిర్వహించింది.	ఇండియన్ ఇన్‌స్టిట్యూట్ ఆఫ్ టెక్నాలజీ మద్రాస్ (ఐఐటీ-ఎం) పరిశోధన పార్క్ వారు పిల్లల కోసం ఒక పోటీ నిర్వహించారు.	భారతీయ సాంకేతిక విశ్వవిద్యాలయం మద్రాస్ (ఐఐటి-ఎం) పరిశోధనా పార్క్ పిల్లల కొరకు పోటీని నిర్వహించింది.
"External affairs minister S Jaishankar on Tuesday expressed concern over the attack on a Hindu temple in Canada, describing the incident as ""deeply concerning."	"బహిరామాయణ మామిడి ఎస్ జయశంకర్ గారు మంగళవారం కెనడాలో ఒక హిందూ దేవాలయంపై దాడి జరిగిందని ఆక్షేపించారు, ఈ ఘటనను ""గంభీరంగా చింతిస్తున్నట్లు చెప్పారు."	"మంగళవారం విదేశీ వ్యవహారాల మంత్రులు ఎస్. జైశంకర్ కెనడాలోని హిందూ దేవాలయంపై జరిగిన దాడిని గూర్చి ఆవేదన వ్యక్తం చేస్తూ, ఈ ఘటనను ""అత్యంత ఆందోళనకరమైనది""గా వర్ణించారు."	"విదేశీ వ్యవహారాల మంత్రులు ఎస్ జైశంకర్ మంగళవారం కెనడాలో హిందూ దేవాలయంపై జరిగిన దాడిపై ఆందోళన వ్యక్తం చేసి, ఈ సంఘటనను ""చాలా ఆందోళనకరమైనది"" అని వర్ణించారు."
Modi condemns violence after Canada temple inciden.	మోడీ క్యానడా గుడి ఘటన తర్వాత హింసలను ఖండిస్తున్నారు.	మోడీ గారు కెనడా దేవాలయ సంఘటన తర్వాత హింసను ఖండించారు.	మోదీ గారు కెనడా ఆలయ సంఘటన తరువాత హింసను ఖండిస్తున్నారు.
Mr Nijjar had been a vocal supporter of the Khalistan movement and publicly campaigned for it.	శ్రీ నిజ్జరు ఖాలిస్తాన్ ఆందోళనకు ప్రత్యేక పోషకుడు మరియు ప్రజాలకు ప్రచారం చేసినట్లు గలవారం ఉంది.	నిజ్జర్ గారు ఖలిస్థాన్ ఉద్యమానికి గట్టిగా మద్దతు తెలిపి, అందుకు బహిరంగంగా ప్రచారం చేశారు.	శ్రీ నిజ్జార్ గారు ఖలిస్తాన్ ఉద్యమానికి సార్వజనీనంగా మద్దతు ప్రకటించారు మరియు దానికోసం ప్రజాస్వామ్యంగా ప్రచారం చేశారు.
Bangladesh steps up repayments to Adani to avoid power supply cu.	బంగ్లాదేశ్ అడానికి విద్యుత్ సరఫరాలను తగ్గించడానికి ధరపెట్టినప్పుడు మెరుగుపరుస్తోంది.	బంగ్లాదేశ్ విద్యుత్ సరఫరా లోపాన్ని నివారించడానికి అదానీకి రీపేమెంట్స్‌ను పెంచుతున్నారు.	బంగ్లాదేశ్ అధికారులు అదానీకి విద్యుత్ సరఫరా కొరత నివారించేందుకు చెల్లింపులను పెంచుతున్నారు.
The country is already suffering from increased power shortages in rural areas.	దేశం ఇప్పుడు గ్రామీణ ప్రాంతాలలో పరిధిలు పెరుగుతున్న విద్యుత్ అభావానికి ఇప్పుడు దుఃఖం అనుభవిస్తున్నది.	దేశం గ్రామీణ ప్రాంతాల్లో పెరిగిన విద్యుత్ లోపాల కారణంగా ఇప్పటికే నష్టపోతున్నది.	దేశం ఇప్పటికే గ్రామీణ ప్రాంతాల్లో పెరిగిన విద్యుత్ లోపాలను అనుభవిస్తున్నది.
Officials said 44 people were on board when the driver lost control and the bus fell into a 50m-deep ditch in Marchula, located in the state’s Almora district.	అధికారులు చెప్పారు డ్రైవరు నియంత్రణ పోయినా బస్ మార్చులలో, ఆల్మోరా జిల్లా లో ఉన్న మార్చులలో ఒక 50m లో వీడియ పొయింది మార్చులలో ఉన్న 44 మంది యాత్రగారులు ఉన్నట్టుగా.	అధికారులు తెలిపారు, డ్రైవర్ నియంత్రణ కోల్పోయినప్పుడు 44 మంది బస్సులో ప్రయాణిస్తున్నారని, ఆ బస్సు రాష్ట్రంలోని అల్మోరా జిల్లాలోని మార్చులాలో 50 మీటర్ల లోతైన గుంతలో పడిపోయిందని.	అధికారులు చెప్పినట్లు, మార్చులాలోని అల్మోరా జిల్లాలో ఉన్న ఒక 50మీటర్ల లోతున్న కందకంలో బస్సు పడిపోయినప్పుడు డ్రైవరు నియంత్రణ కోల్పోయినప్పుడు బస్సులో 44 మంది ఉన్నారు.
Uttarakhand's Chief Minister Pushkar Singh Dhami has also announced financial assistance for the victims and their families.	ఉత్తరాఖండ్ ముఖ్యమంత్రులు పుష్కర్ సింగ్ ధామి వాధ్యమండలం ప్రభుత్వోల్లకు ఆత్మీయులకు మరియు వారి కుటుంబాలకు ఆర్థిక సహాయం ప్రకటించారు.	ఉత్తరాఖండ్ ముఖ్యమంత్రి పుష్కర్ సింగ్ ధామి గార్లు బాధితులు మరియు వారి కుటుంబాలకు ఆర్థిక సహాయం ప్రకటించారు.	ఉత్తరాఖండ్ ముఖ్యమంత్రులు పుష్కర్ సింగ్ ధామీలు బాధితులకు మరియు వారి కుటుంబాలకు ఆర్థిక సహాయాన్ని కూడా ప్రకటించారు.
Our scientists used it as an incentive to develop their own technology.	మా విజ్ఞానికులు వారి స్వంత సాంకేతికం అభివృద్ధి చేయడానికి ఉపయోగించారు.	మా శాస్త్రవేత్తలు తమ సొంత సాంకేతికతను అభివృద్ధి చేయడానికి దీనిని ప్రేరణగా ఉపయోగించారు.	మన శాస్త్రవేత్తలు దాన్ని తమ స్వంత సాంకేతికతను అభివృద్ధి చేయడానికి ప్రోత్సాహకారంగా ఉపయోగించారు.
Mylswamy Annadurai, chief of India’s first and second Moon missions and Mars mission, told the BBC that Isro employs far fewer people and pays lower salaries, which makes Indian projects competitive.	మైల్స్వామి అన్నాదురై, భారతదేశంలో మొదటి మరియు రెండవ చంద్ర మిషన్ల మరియు మంగల మిషన్ల అధికారి, బీబీసికి చెప్పినంత భారత ప్రాజెక్ట్లు పోరాటాత్మకంగా చేయడానికి ఐఎస్రో వాడు చాలా తక్కువ మందిని నియోజిస్తుంది మరియు అధిక జీతం ఇస్రో యొక్క స్పర్ధాత్మకతను పెంచుకుంది.	భారతదేశపు మొదటి మరియు రెండవ చంద్ర మిషన్లు మరియు మార్స్ మిషన్‌లకు చీఫ్ అయిన మైల్స్వామి అన్నదురై గారు, ఇస్రో తక్కువ మంది ఉద్యోగులను నియమించుకుంటుందని మరియు తక్కువ జీతాలు ఇస్తుందని, తద్వారా భారతీయ ప్రాజెక్టులు పోటీదారులు అవుతాయని బీబీసీకి చెప్పారు.	మైల్స్వామి అన్నదురై, భారతదేశం యొక్క మొదటి మరియు రెండవ చంద్ర మిషన్లు మరియు మార్స్ మిషన్ యొక్క ప్రధానులు, బిబిసికి చెప్పారు కి ఇస్రో చాలా తక్కువ మంది ఉద్యోగులను నియమిస్తుంది మరియు తక్కువ జీతాలను చెల్లిస్తుంది, ఇది భారతీయ ప్రాజెక్టులను పోటీతత్వంలో ఉంచుతుంది.
Ex-district president of Bajrang Dal Gurgaon held for shooting at Gurgaon man.	గుర్గాం లో గుర్గాం ప్రజాసేవ సంఘం నియోజకుడు కార్యదర్శి గుర్గాం మనిషిని గుర్గాం లో గుర్గాం లో గుర్గాం లో గుర్గాం లో గుర్గాం లో గుర్గాం లో గుర్గాం లో గుర్గాం లో అట్లు మరియు ధరించింది.	గుర్గావ్ వ్యక్తిపై కాల్పులు జరిపిన బజరంగ్ దళ్ మాజీ జిల్లా అధ్యక్షుడిని గుర్గావ్ పోలీసులు అదుపులోకి తీసుకున్నారు.	బజరంగ్ దళ్ గుర్గావ్ మాజీ జిల్లా అధ్యక్షులు గుర్గావ్ వ్యక్తిపై కాల్పులు జరిపినందుకు అరెస్టు చేయబడ్డారు.
The legendary Bob Khathing led the expedition to peacefully integrate Tawang into India.	దీర్ఘకాల చరిత్రలో గౌరవాన్వితమైన బాబ్ ఖాతింగ్ తావాంగ్ను భారతదేశంలో శాంతిగా ఏకీకరించడానికి అభియానం నడుస్తున్నారు.	ప్రసిద్ధ బాబ్ ఖాథింగ్ గారు తవాంగ్‌ను శాంతియుతంగా భారత్‌లో చేరమని మార్గదర్శనం చేశారు.	ప్రసిద్ధ బాబ్ ఖాతింగ్ గారు భారతదేశంలో తావాంగ్ ను శాంతియుతంగా విలీనం చేసే యాత్రకు నాయకత్వం వహించారు.
In 1939, after the Second World War broke out, Khathing joined the Indian Army and got an Emergency Commission as an officer.	1939 లో, దద్దరి ప్రపంచ యుద్ధం ప్రారంభమైన తరువాత, ఖతింగ్ భారత సేనలో చేరినట్టుగా, ఒక ఆపాద ఆధికారిక కామిషన్ పొందినట్టుగా.	1939లో, రెండో ప్రపంచ యుద్ధం ప్రారంభమైన తర్వాత, ఖాతింగ్ భారత సైన్యంలో చేరి అధికారిగా అత్యవసర కమిషన్ పొందారు.	1939లో రెండవ ప్రపంచ యుద్ధం ప్రారంభమైన తరువాత, ఖాతింగ్ భారతీయ సైన్యంలో చేరి అధికారులు వారు తురువాత జరుగు కమిషన్ పొందారు.
At the end of the Second World War, the Emergency Commissioned officers in the Army were demobilised.	ద్వితీయ ప్రపంచ యుద్ధం ముగిసి తరువాత, సేనలోని అత్యావశ్యక అధికారులు డిమోబిలైజ్ చేయబడ్డారు.	రెండవ ప్రపంచ యుద్ధం ముగిసిన తర్వాత, ఆర్మీలో ఉన్న ఎమర్జెన్సీ కమిషన్డ్ అధికారులను తాత్కాలికంగా విడుదల చేసారు.	రెండవ ప్రపంచ యుద్ధం ముగింపులో, సైన్యంలోని జరూరీ కమిషన్డ్ అధికారులు విడుదల చేయబడ్డారు.
Most of the senior cricketers were far from their best, especially against New Zealand.	అనేక ప్రధాన క్రికెటర్లు తమ అతీతంలో తమ మీద ప్రధానతలో నిలిచిపోయారు, ప్రత్యేకంగా న్యూజిల్యాండ్ వరకు.	ప్రముఖ క్రికెటర్లలో చాలామంది తమ ఉత్తమ ప్రదర్శనకు దూరంగా ఉన్నారు, ముఖ్యంగా న్యూజిలాండ్‌తో జరిగిన మ్యాచ్‌లలో.	ఎక్కువ సీనియర్ క్రికెటర్లు వారి ఉత్తమం నుండి చాలా దూరంలో ఉన్నారు, న్యూజిలాండ్ పైన ముఖ్యంగా.
