src	gpt_3_5_trans	gpt_4o_trans	ollama_trans
JMM says Soren's helicopter take off delayed over PM's security protocol, writes to President Murmu	JMM సోరెన్ హెలికాప్టర్ పీఎం భర్తీ షాఖా మీదున్నది తడిమడించింది, ప్రేసిడెంట్ మూర్ముకు రాయబడింది.	జేఎమ్‌ఎం చెబుతోంది: ప్రధాని భద్రతా ప్రమాణాల కారణంగా సోరెన్ హెలికాప్టర్ టేకాఫ్ ఆలస్యం అయిందని రాష్ట్రపతి ముర్ముకు లేఖ రాశారు.	జేఎంఎం ప్రకారం పీఎం భద్రతా ప్రోటోకాల్ కారణంగా సోరెన్ హెలికాప్టర్ టేకాఫ్ ఆలస్యం అయింది, రాష్ట్రపతి ముర్ముకు లేఖ వ్రాసింది.
The king who defied the British: Uncovering the tale of Pazhassi raja’s rebellion	బ్రిటిష్ ని పనిచేసిన రాజను ఎప్పుడూ విముక్తం చేసిన రాజా: పాఝసీ రాజా ప్రత్యేక కథనానికి అంటారు.	బ్రిటిష్ వారికి ఎదిరించిన రాజు: పళసి రాజా తిరుగుబాటు కథను వెలికితీస్తూ	బ్రిటిష్ వారిని ఎదిరించిన రాజు: పాళయి రాజా తిరుగుబాటు కథ వెలుగులోకి
Vinesh Phogat's retirement U-turn predicted after her latest Instagram post creates buzz on social media	వినేష్ ఫోగాట్ తన ఇటనాగ్రామ్ పోస్టు వలన సోషల్ మీడియాలో ఉత్తరము పూర్వకనుకరించబోతుందని అనుకూలమవలిస్తున్నదని భవిష్య అందించలెనని ఊహించబడ్డింది.	వినేష్ ఫోగాట్ రిటైర్మెంట్ నిర్ణయాన్ని మార్చుకున్నట్లు ఊహించబడింది, ఆమె తాజా ఇన్‌స్టాగ్రామ్ పోస్ట్ సోషల్ మీడియాలో చర్చనీయాంశంగా మారింది.	వినేశ్ ఫోగట్ యొక్క రిటైర్మెంట్ యు-టర్న్ ఆమె లేటెస్ట్ ఇన్స్టాగ్రామ్ పోస్ట్ సోషల్ మీడియాలో బజ్ సృష్టించింది.
The Pennsylvania push: Kamala Harris, Donald Trump spend final campaign hours in swing state	పెన్సిల్వేనియా పుష్: కమలా హారిస్, డొనాల్డ్ ట్రంప్ స్వింగ్ రాష్ట్రంలో చివరి క్యాంపైన్ అవుట్లు కళనికి వ్యయం చేస్తున్నారు.	పెన్సిల్వేనియా నొక్కు: కమల హారిస్, డోనాల్డ్ ట్రంప్ స్వింగ్ రాష్ట్రంలో చివరి ప్రచార గంటలు గడుపుతున్నారు.	పెన్సిల్వేనియా పుష్: కమలా హారిస్, డొనాల్డ్ ట్రంప్ స్వింగ్ స్టేట్లో చివరి ప్రచార గంటలు గడిపారు.
Delhi engulfed in smog, toxic foam in Yamuna: Pics that capture national capital's pollution woes	దిల్లీలో స్మాగ్ లో మంజన కింద వాస్తవం: రాష్ట్ర రాజధానికి వాతావరణ అంశాలు పటం చేసే చిత్రాలు	ఢిల్లీ పొగమంచులో మునిగిపోయింది, యమునాలో విషపూరిత నురుగు: జాతీయ రాజధాని కాలుష్య సమస్యలను చూపించే చిత్రాలు.	ఢిల్లీ స్మోగ్ లో మునిగిపోయింది, యమునాలో విషపూరిత ఫోమ్: జాతీయ రాజధాని యొక్క కాలుష్య సమస్యలను చిత్రీకరించే ఫోటోలు.
Will Muslim boycott of Kamala send Trump to the White House?	కమలను వద్దుకునే ముస్లిం బోయ్కాట్ ట్రమ్ప్ని వైట్ హౌస్కు పంపిస్తుందా?	ముస్లింల బహిష్కరణ వల్ల కమలాకు ట్రంప్ వైట్ హౌస్‌కు వెళ్లే అవకాశం ఉందా?	కమలాను ముస్లింలు బహిష్కరిస్తే ట్రంప్ వైట్ హౌస్ చేరుకుంటాడా?
Why Indian batters are struggling against left-arm spin	ఇండియన్ బ్యాటర్లు ఎడమ కోణం వ్యాయామ విరుద్ధంగా మిడుగువుతున్నారు ఏమిటి?	భారత బ్యాట్స్‌మెన్ ఎడమచేతి స్పిన్ బౌలింగ్‌కు వ్యతిరేకంగా ఎందుకు ఇబ్బంది పడుతున్నారు?	ఎందుకు భారతీయ బ్యాటర్లు ఎడమచేతి స్పిన్ కి ఇబ్బంది పడుతున్నారు
JD Vance calls Kamala Harris 'trash' at Atlanta rally: 'In 2 days we're taking out the garbage'	జెడి వాన్స్ అట్లాంటా ర్యాలీలో కమలా హ్యారిస్ను 'ధమ్ముకు' అంటున్నాడు: '2 రోజులో మేము కచితంగా విషం తీసుకోతాము'	JD వాన్స్ అట్లాంటా సభలో కమల హ్యారిస్‌ను 'చెత్త' అని పిలుస్తూ: 'ఇంకా 2 రోజుల్లో మనం చెత్తను తొలగిస్తున్నాము' అని అన్నారు.	జేడీ వాన్స్ అట్లాంటా రాలీలో కమలా హారిస్‌ను 'చెత్త' అని పిలుస్తున్నాడు: '2 రోజుల్లో మేము చెత్తను తొలగిస్తున్నాము'
Meghan and Harry feel life in US hasn't been what they expected: Ex-staff	మేఘన్ మరియు హ్యారీ US లో జీవితం అంటే అందరికీ ఆశిస్తున్నట్లేదు అని అనుభవించుకున్నారు: మరియు Ex-స్టాఫ్	మెగన్ మరియు హ్యారీ అనుభవిస్తున్నారంటే అమెరికాలో జీవితం వారు ఆశించినంతగా లేదు: మాజీ సిబ్బంది	మెగాన్, హారీ అమెరికాలో జీవితం వారు ఆశించినది కాదని మాజీ సిబ్బంది చెబుతున్నారు.
Elon Musk reacts to reports that he could be deported for immigration violation	ఇమోగల్ను లేదా ఇమ్మిగ్రేషన్ పాలన విలన్ కారణంగా నిషేధించడం వల్ల దూరంగా చెల్లుబారని అంగీకరిస్తున్న ఎలాన్ మస్క్	ఇలాన్ మస్క్ వలస నిబంధనలు ఉల్లంఘించారని తనను తాను దేశం నుండి పంపించివేయవచ్చని వచ్చిన నివేదికలపై స్పందించారు.	ఎలాన్ మస్క్ ఇమ్మిగ్రేషన్ ఉల్లంఘన కారణంగా బహిష్కరించబడే అవకాశం ఉందని వార్తలకు స్పందిస్తున్నాడు.
How China is lessening its reliance on helium sourced from US	చైనా ఎలా ఎర్రల నుండి సాగితే అది ఎక్కువ అవసరం పొందుతోంది అనే విషయంపై ఎలా తగ్గించుకుందో చూడండి.	చైనా అమెరికా నుండి అందించబడుతున్న హీలియంపై తన ఆధారాన్ని ఎలా తగ్గిస్తుంది.	చైనా యుఎస్ నుండి వచ్చే హీలియం మీద తన ఆధారతను తగ్గిస్తోంది.
Kindle Colorsoft owners complain of a yellow bar on the e-reader’s screen	కిండల్ కలర్సాఫ్ట్ యజమానులు ఇ-రీడర్ స్క్రీన్‌పై ఎరుపు బార్ గురించి ఫిక్స్ చేయబడుతున్నారు.	కిండిల్ కలర్‌సాఫ్ట్ యజమానులు ఈ-రిడర్ స్క్రీన్‌పై నీలం రంగు పట్టీ గురించి ఫిర్యాదు చేస్తున్నారు.	కిండిల్ కలర్సాఫ్ట్ యజమానులు ఈ-రీడర్ స్క్రీన్లో పసుపు బార్ గురించి ఫిర్యాదు చేస్తున్నారు.
Nvidia and its partners built a sophisticated system to bypass U.S. restrictions on exporting AI chips to the Middle East, Russia, and China.	ఎన్విడియా మరియు ఆ భాగస్వాములు మధ్య ప్రాంతాలకు, రష్యా, మరియు చైనాకు AI చిప్స్ను ఎగ్జాపోర్ట్ చేయడానికి U.S. పరిమితులను దాటడానికి ఒక సాహిత్యవిద్యా వ్యవస్థ నిర్మించింది.	ఎన్‌విడియా మరియు దాని భాగస్వాములు మధ్యప్రాచ్యం, రష్యా మరియు చైనాకు AI చిప్‌ల ఎగుమతిపై అమెరికా ఆంక్షలను దాటవేయడానికి ఒక సొఫిస్టికేటెడ్ సిస్టమ్‌ను నిర్మించారు.	న్విడియా మరియు దాని భాగస్వాములు మధ్య ప్రాచ్యం, రష్యా, చైనాకు AI చిప్స్ ఎగుమతిపై యుఎస్ నిబంధనలను తప్పించేందుకు ఒక సోఫిస్టికేటెడ్ వ్యవస్థను నిర్మించారు.
The funding, which will top up the firm’s flagship fund, will be raised primarily from institutional investors. 	ఈ నిధులు, కంపెనీ అధీనస్థ నివేశకుల నుండి ప్రధానంగా పెంపుదల చేసే ముఖ్యంగా ఫ్లాగ్‌షిప్ ఫండ్ ను కలిగిస్తుంది.	ఈ నిధి, ఇది సంస్థ యొక్క ప్రధాన నిధిని పెంచుతుంది, ప్రధానంగా సంస్థాగత పెట్టుబడిదారుల నుండి సేకరించబడుతుంది.	సంస్థ యొక్క ప్రధాన నిధిని పూరించే ఈ నిధి ప్రధానంగా సంస్థాగత పెట్టుబడిదారుల నుండి సేకరించబడుతుంది.
US Forest Service Decision to Halt Prescribed Burns in California is History Repeating	క్యాలిఫోర్నియాలో ప్రెస్క్రైబ్ బర్న్స్ ఆపరేషన్లను ఆపడానికి US అటని నిర్ణయం ఆపుకుంది చరిత్ర మళ్ళీ పునరావృతం అయింది.	అమెరికా అటవీ సేవ నిర్ణయం కాలిఫోర్నియాలో నియమిత దహనాలను ఆపివేయడం చరిత్ర పునరావృతమవుతోంది.	కాలిఫోర్నియాలో ప్రెస్క్రైబ్డ్ బర్న్స్ నిలిపివేసే యుఎస్ ఫారెస్ట్ సర్వీస్ నిర్ణయం చరిత్ర పునరావృతం.
The man who gave us the solution to the Entscheidungsproblem	ఎంట్షెెెఇడున్గ్స్ప్రొబ్లెమ్ కి సమాధానం ఇచ్చిన మనుష్యను	ఎన్‌షైడుంగ్‌ప్రాబ్లెం పరిష్కారాన్ని మాకు అందించిన వ్యక్తి.	ఎంట్స్‌చైడంగ్స్‌ప్రోబ్లెం పరిష్కారాన్ని మనకు ఇచ్చిన వ్యక్తి
The shift in policy, covering government agencies and contractors working on national security, is intended to promote “responsible and ethical” innovations, the company said.	"రాజకీయ విధానంలో మారాయి, జాతీయ భద్రతకు పనిచేసే ప్రభుత్వ వడేవిలలు మరియు కంట్రాక్టర్లను ""జవాబ్దారిక మరియు నైతిక"" ప్రవర్తనలను ప్రోత్సాహించడం లక్ష్యంగా ఉందని కంపెనీ చెబిని చెప్పింది."	నీతులు మరియు కాంట్రాక్టర్లకు వర్తించే విధానంలో మార్పు, జాతీయ భద్రత పై పనిచేస్తున్నవారికి, “బాధ్యతాయుతం మరియు నైతిక” ఆవిష్కరణలను ప్రోత్సహించడానికి ఉద్దేశించబడింది, అని కంపెనీ తెలిపింది.	"జాతీయ భద్రతా పనులపై పనిచేసే ప్రభుత్వ సంస్థలు, కాంట్రాక్టర్లకు విస్తరించే విధాన మార్పు, ""నైతిక మరియు బాధ్యతాయుత"" నూతన ఆవిష్కరణలను ప్రోత్సహించడానికి ఉద్దేశించబడింది, కంపెనీ చెప్పింది."
China reveals a new heavy lift rocket that is a clone of SpaceX’s Starship	చైనా స్పేస్‌ఎక్స్ యొక్క స్టార్‌షిప్ యనంతరం క్లోన్ ఉన్న కొత్త భారీ లిప్త్ రాకెట్ ప్రకటించింది.	చైనా స్పేస్‌ఎక్స్ యొక్క స్టార్షిప్‌ను అనుకరించిన కొత్త హెవీ లిఫ్ట్ రాకెట్‌ను ప్రకటించింది.	చైనా స్పేస్‌ఎక్స్ యొక్క స్టార్‌షిప్ యొక్క క్లోన్ అయిన కొత్త భారీ ఎత్తు రాకెట్ ను వెల్లడించింది.
Singapore requires vehicle owners to bid for a set number of Certificates of Entitlement – costly operating permits valid for only ten years.	సింగపూర్ గాడి యజమానులు కొనసాగిన సరకు సర్టిఫికేట్ల ఆఫ్ ఎంటిటిల్ కోసం బిడ్ చేయాలి - మాత్రమే పది ఏళ్ళు మాత్రమే చెల్లించే శుల్కం చేతులు.	సింగపూర్‌లో వాహన యజమానులు పరిమిత సంఖ్యలో ఉన్న హక్కుల ధ్రువపత్రాల కోసం బిడ్ వేయాలి – ఇవి కేవలం పది సంవత్సరాల పాటు మాత్రమే చెల్లుబాటు అయ్యే ఖరీదైన ఆపరేటింగ్ అనుమతులు.	సింగపూర్ వాహన యజమానులు పది సంవత్సరాల కాలం మాత్రమే విలువైన ఆపరేటింగ్ పర్మిట్లు అయిన ఎంటిటీల ఆఫ్ ఎంటైటిల్మెంట్ కొరకు బిడ్ చేయాలి.
The Hwasong-19 is North Korea’s biggest missile yet and its test comes during a time of notable tensions on the peninsula.	హ్వాసంగ్-19 ఉత్తర కొరియా సొమ్ము మిసైల్ అయినది మరియు ఇది ప్రాయంలో పెనిన్సులా మేలుగా వివాదాత్మక సందేహాల సమయంలో పరీక్ష చేయబడింది.	హ్వాసోంగ్-19 ఉత్తర కొరియా యొక్క ఇప్పటివరకు అతిపెద్ద క్షిపణి మరియు దాని పరీక్ష ద్వీపకల్పంలో గమననీయమైన ఉద్రిక్తతల సమయంలో వస్తోంది.	హ్వాసాంగ్-19 ఉత్తర కొరియా యొక్క అతిపెద్ద క్షిపణి మరియు దీని పరీక్ష సమయంలో ద్వీపకల్పంలో గణనీయమైన ఉద్రిక్తతలు ఉన్నాయి.
The species may have been carried to the Sacramento–San Joaquin Delta in ballast water on ships	ఈ జాతి పోతముల నీటిలో బందాలం వాహనాలలో సాక్రమెంటో-సాన్ హోకిన్ డెల్టకు తీసుకువలసినవి ఉంటుంది.	ఆ ప్రజాతి నౌకలలో బల్లాస్ట్ నీటిలో సాక్రమెంటో-సాన్ జోక్విన్ డెల్టాకు తేలిపోయి ఉండవచ్చు.	శిప్స్ లోని బాలస్ట్ వాటర్ ద్వారా సాక్రమెంటో-సాన్ జోక్విన్ డెల్టాకు ఈ జాతి తీసుకువెళ్ళబడి ఉండవచ్చు.
Discovery partnered with PR firm Relevance International to produce ultra-luxury experiences and products under the banner of fictionaire billionaire Bruce Wayne’s conglomerate.	డిస్కవరీ పార్ట్నర్షిప్ మూలంగా పిఆర్ ఫిర్మ్ రిలవన్స్ ఇంటర్నేషనల్ తో ఫిక్షన్ఎయర్ బిల్లీయన్ బ్రూస్ వేయిన్'స్ కాంగ్లొమరేట్ కి అధీనంలో అల్ట్రా-లక్షర్య్ అనుభవాలు మరియు ఉత్పత్తులను తయారు చేయడానికి సహాయపడింది.	డిస్కవరీ, పీఆర్ సంస్థ రిలేవెన్స్ ఇంటర్నేషనల్‌తో భాగస్వామ్యం చేసి కల్పిత కోటీశ్వరుడు బ్రూస్ వేన్ యొక్క సమూహం పేరులో అల్ట్రా-లగ్జరీ అనుభవాలు మరియు ఉత్పత్తులను తయారు చేసింది.	డిస్కవరీ పిఆర్ ఫర్మ్ రెలెవన్స్ ఇంటర్నేషనల్ తో కలిసి ఫిక్షనైర్ బిల్లియనైర్ బ్రూస్ వేన్ యొక్క కాంగ్లోమరేట్ పతాకాపై అత్యంత లాక్షరీ అనుభవాలు మరియు ఉత్పత్తులను ఉత్పత్తి చేసింది.
Water utilities and chemical manufacturers are challenging the new EPA standards. 	నీటి పరికరాలు మరియు రసాయన నిర్మాతలు కొత్త EPA మానకాలను చాలెంజ్ చేస్తున్నారు.	నీటి వినియోగ సంస్థలు మరియు రసాయన తయారీదారులు కొత్త EPA ప్రమాణాలను సవాలు చేస్తున్నారు.	నీటి సదుపాయాలు మరియు రసాయన తయారీదారులు కొత్త EPA ప్రమాణాలను సవాలు చేస్తున్నారు.
A radio station in Poland fired its on-air talent and brought in A.I.-generated presenters. An outcry over a purported chat with a Nobel laureate quickly ended that experiment.	పోలంలో ఒక రేడియో స్టేషన్ తన ఆన్-ఎయిర్ సామర్థ్యంను ఫైర్ చేసి, ఏ.ఐ.-సృష్టించబడిన ప్రస్తుతారాలను తరువాత చేర్చారు. నోబెల్ అంబ్లరేట్తో ప్రతిష్ఠానించబడిన చాట్ పై ఒక తక్షణమే ఆ ప్రయోగానికి అంతము పెట్టింది.	పోలాండ్‌లోని ఒక రేడియో స్టేషన్ తన ప్రసార ప్రతిభను తొలగించి, AI-సృష్టించిన వ్యాఖ్యాతలను తీసుకువచ్చింది. ఒక నోబెల్ బహుమతి విజేతతో జరిగినట్లు భావించిన చాట్‌పై వ్యతిరేకత వల్ల ఆ ప్రయోగం త్వరగా ముగిసింది.	పోలాండ్ లో ఒక రేడియో స్టేషన్ తన ఆన్-ఎయిర్ ప్రతిభావంతులను తొలగించి ఎయిఐ-జనరేటెడ్ ప్రజెంటర్లను తీసుకువచ్చింది. ఒక నోబెల్ లారియేట్ తో పురాతన చర్చ కొరకు ఆ ప్రయోగం త్వరగా ముగిసింది.
From infancy, children show heightened interest in events that are impossible or improbable, relative to likely events.	పుట్టినిందు, పిల్లలు సాధ్యమైన లేక అసాధ్యమైన ఘటనలపై పెరగా ఆసక్తి చూపిస్తారు.	శిశువయస్సు నుండి, పిల్లలు సాధ్యమైన సంఘటనలతో పోలిస్తే అసాధ్యం లేదా అసంభవం అయిన సంఘటనలపై ఎక్కువ ఆసక్తిని చూపిస్తారు.	శిశువులు అసాధ్యమైన లేదా అప్రయత్నమైన సంఘటనలపై సాధ్యమైన సంఘటనల కంటే ఎక్కువ ఆసక్తిని ప్రదర్శిస్తారు.
Four persons were referred to hospital and the rest were treated as outpatients at the event venue, police sources said.	పోలీసు మూలం గుర్తించినందుకు నాలుగు వ్యక్తులు ఆస్పత్రికి నిర్దేశించబడినవి మరియు మిగిలినవి ఈవెంట్ వేన్యూలో ఔట్‌పేషంట్లగా చికిత్స చేయబడినవి.	నాలుగు మంది వ్యక్తులను ఆసుపత్రికి పంపించగా, మిగతా వారిని ఈవెంట్ ప్రాంగణంలో అవుట్‌పేషెంట్‌లుగా చికిత్స చేశారు అని పోలీస్ వర్గాలు తెలిపాయి.	నలుగురు ఆసుపత్రికి పంపబడ్డారు, మిగిలిన వారు ఈవెంట్ వేదికపై అవుట్ పేషెంట్లుగా చికిత్స పొందారు, పోలీస్ సోర్సులు చెప్పాయి.
During investigation, the Washermenpet police found that he was attacked by three persons with stones and beer bottles while he was consuming alcohol.	తనకు మద్యం సెవితోయిన తర్వాత మూడు వ్యక్తులు పథ్రాలు మరియు బీరు బాటల్లుతో దాడుతున్నారని వాషర్మెన్పేట్ పోలీసులు విచారణ నడుస్తుంది.	దర్యాప్తు సమయంలో, వాషర్‌మెన్‌పేట్ పోలీసులు అతను మద్యం సేవిస్తున్నప్పుడు ముగ్గురు వ్యక్తులు రాళ్లు మరియు బీర్ సీసాలతో దాడి చేశారని కనుగొన్నారు.	దర్యాప్తులో, వాషర్మెన్ పేట పోలీసు అతను మూడు వ్యక్తులచే రాళ్ళు, బీరు సీసాలతో దాడి చేయబడినట్లు, అతను మద్యం సేవిస్తున్న సమయంలో కనుగొన్నారు.
Two juvenile boys who were lodged at the Government Observation Home in Chengalpattu escaped on Tuesday night.	చింగలపట్టులో సర్కారు మోనిటరింగ్ హోమ్లో నివాసిస్తున్న రెండు యువకులు మంగళవారం రాత్రి ఓటమ్బరు వెళ్లారు.	చెంగల్పట్టు లోని ప్రభుత్వ పరిశీలన గృహంలో నిర్బంధించబడిన ఇద్దరు బాలురు మంగళవారం రాత్రి తప్పించుకున్నారు.	చెంగల్పట్టులోని ప్రభుత్వ పరిశీలన ఇల్లులో ఉన్న ఇద్దరు కిషోరులు మంగళవారం రాత్రి తప్పించుకున్నారు.
During Mr. Gandhi’s Srinagar stay, men disembarked from cars on Boulevard road to hug him.	శ్రీనగర్లో మిస్టర్ గాంధీ ఉండినప్పుడు, మెన్ లు బౌలేవార్డ్ రోడ్ నుండి కార్లు నుండి తెరిచినారు మరియు ఆతను అందించడానికి గూడించడానికి ఆమెను నమస్కరించారు.	"మీరు అందించిన వాక్యాన్ని తెలుగులో ఇలా అనవచ్చు: ""గాంధీ గారి శ్రీనగర్ పర్యటనలో, బౌలేవార్డ్ రోడ్డుపై కార్ల నుండి దిగిన వ్యక్తులు ఆయనను ఆలింగనం చేసుకున్నారు."""	గాంధీ గారు శ్రీనగర్ లో ఉన్నప్పుడు, బులెవార్డ్ రోడ్డుపై కార్ల నుండి దిగి ఆయన్ని కౌగలించుకున్నారు.
They alleged that several brick kilns started selling old stocks of bricks from Wednesday after paying the first instalment of the fine levied on them by the Geology and Mining Department.	వారంలో జియోలజీ మరియు ఖని శాఖ ద్వారా ధరించిన ధంధాపు ప్రారంభం తరువాత కొందరు ఈ శుక్రవారం నుంచి పాలనకు వస్తున్న పురాణ స్టాక్స్ అమ్మినట్లు ముద్రించారని వాదించారు.	అవి ఆరోపించాయి कि భూశాస్త్రం మరియు మైనింగ్ శాఖ ద్వారా వాటిపై విధించిన జరిమానా యొక్క మొదటి విడత చెల్లించిన తర్వాత బుధవారం నుండి అనేక ఇటుక బట్టీలు పాత నిల్వల ఇటుకలను విక్రయించడం ప్రారంభించాయి.	వారు భూగర్భ శాస్త్ర మరియు గని శాఖ వారిచే విధించబడిన జరిమానా యొక్క మొదటి విడత చెల్లించిన తరువాత బుధవారం నుండి పాత ఇటుకల స్టాక్లను అమ్మడం ప్రారంభించాయని ఆరోపించారు.
Ten Indian career diplomats, who are High Commissioners or Ambassadors of India in other countries, called on Governor R.N. Ravi at the Raj Bhavan in Chennai on Monday.	భారతీయ మహానియంతులు, ఇతర దేశాలలో భారత హై కమిషనర్లు లేదా దూతాలు ఉన్నారు, రాజ్ భవన్నలో మంగళవారం చెన్నైలో గవర్నర్ ఆర్.ఎన్. రవిని కలిసినారు.	భారతదేశం నుండి ఇతర దేశాలలో ఉన్న హై కమీషనర్లు లేదా రాయబారులు అయిన పది మంది భారతీయ కెరీర్ డిప్లొమాట్లు సోమవారం చెన్నైలోని రాజ్ భవన్‌లో గవర్నర్ ఆర్.ఎన్. రవిని కలుసుకున్నారు.	భారతదేశంలో ఇతర దేశాలలో హై కమిషనర్లు లేదా అంబాసిడర్లుగా ఉన్న పది మంది భారతీయ కెరీర్ డిప్లోమాట్స్ సోమవారం చెన్నైలోని రాజ్ భవన్ లో గవర్నర్ ఆర్.ఎన్. రవిని కలిశారు.
However, Dr. Hande, who wrote the foreword for her book and took part in some of these Assembly debates, says Muthu discharged her duty efficiently as a Minister with no room for corruption.	కానీ, తన పుస్తకంకు ప్రారంభ పత్రం రాయబూతి చేసిన డా. హందే, ముతు తన కట్టలు ఆసెంబ్లీ చర్చలలో చేసినట్లు, కొరిప్షన్ రూము లేనంత మంత్రివర్గంగా ముతు తన దైహిక కర్తవ్యాన్ని యాక్షస్తగా పాలన చేశిందని హందే చెబుతున్నారు.	అయితే, ఆమె పుస్తకానికి ముందుమాట రాసిన మరియు కొన్ని అసెంబ్లీ చర్చల్లో పాల్గొన్న డాక్టర్ హాండే, ముత్తు అవినీతికి అవకాశములేకుండా మంత్రి హోదాలో తన విధిని సమర్థవంతంగా నిర్వర్తించిందని చెబుతున్నారు.	అయితే, ఆమె పుస్తకం కొరకు ముందుమాట వ్రాసిన డాక్టర్ హండే, ఈ అసెంబ్లీ చర్చల్లో కొన్నింటిలో పాల్గొన్నారు, ముత్తు మంత్రిగా తన బాధ్యతను సమర్థవంతంగా నిర్వహించింది, అవినీతికి ఎటువంటి స్థలం లేదు.
While both Mr. Lobo and Mr. Kamat have cited disaffection with the Congress high command as reasons, the true reasons are all too transparent.	శ్రీ లోబో మరియు శ్రీ కామట్ రాజకీయ సంసదిక అధికారంతో తమ నిరాశాతో కాంగ్రెస్ ఉచ్చ కమాండ్ ను కారణంగా చేసినట్లు వచ్చినప్పుడు, వాస్తవ కారణాలు అంతే ప్రకటించగలవు.	శ్రీ లోబో మరియు శ్రీ కామత్ ఇద్దరూ కాంగ్రెస్ ఉన్నత కమాండ్‌పై అసంతృప్తిని కారణాలుగా పేర్కొన్నప్పటికీ, నిజమైన కారణాలు చాలా స్పష్టంగా ఉన్నాయి.	లోబో గారు, కామత్ గారు ఇద్దరూ కాంగ్రెస్ హైకమాండ్ తో అసంతృప్తిని కారణాలుగా చెప్పినప్పటికీ, నిజమైన కారణాలు చాలా స్పష్టంగా ఉన్నాయి.
The first festival celebrating the linguistic and cultural ties between the Barak Valley region of Assam and the Sylhet segment of Bangladesh began on Friday evening.	అసామ్ రాష్ట్రంలో బారాక్ వ్యాలీ ప్రాంతం మరియు బాంగ్లాదేశ్ సైల్హెట్ విభాగం మధ్య భాషా మరియు సాంస్కృతిక బంధాలను జయప్రదం చేయు ప్రథమ ఉత్సవం శుక్రవారం సాయంత్రం ప్రారంభమైంది.	ఆసామ్‌లోని బరాక్ వ్యాలీ ప్రాంతం మరియు బంగ్లాదేశ్‌లోని సిల్హెట్ ప్రాంతాల మధ్య భాషా మరియు సాంస్కృతిక సంబంధాలను జరుపుకుంటూ మొదటి ఉత్సవం శుక్రవారం సాయంత్రం ప్రారంభమైంది.	అస్సాం లోని బారక్ వ్యాలీ ప్రాంతం మరియు బంగ్లాదేశ్ లోని సిల్హెట్ విభాగం మధ్య భాషా సాంస్కృతిక బంధాలను జరుపుకునే మొదటి ఉత్సవం శుక్రవారం సాయంత్రం ప్రారంభమైంది.
The objective of such markets is to incentivise investments in renewable energy sources.	అంతవిధముగా, ఈ మార్కెట్లలో పునరుత్థాన శక్తి మూలాలపై నివేశాలను ప్రోత్సాహించడం మార్గం ఉంది.	ఈ మార్కెట్ల లక్ష్యం పునరుత్పాదక ఇంధన వనరులలో పెట్టుబడులను ప్రోత్సహించడం.	ఆవిధ మార్కెట్ల లక్ష్యం పునరుత్పాదక శక్తి వనరుల్లో పెట్టుబడులను ప్రోత్సహించడం.
The Centre is expected to clarify, later this year, the specifics of a carbon trading market in India.	ఈ సెంటర్ ఈ సంవత్సరం తరువాత భారతదేశంలో కార్బన్ ట్రేడింగ్ మార్కెట్ యొక్క విశేషాలను స్పష్టం చేయడానికి అప్సరాలు ఉంటాయి.	ఈ సంవత్సరం చివరలో భారతదేశంలో కార్బన్ ట్రేడింగ్ మార్కెట్ యొక్క ప్రత్యేకతలను కేంద్రం వివరణ ఇవ్వనుందని ఆశిస్తున్నారు.	ఈ సంవత్సరం చివరిలో భారతదేశంలో కార్బన్ ట్రేడింగ్ మార్కెట్ యొక్క వివరాలను కేంద్రం వివరించగలదు.
Hydrogen is an essential industrial fuel that has a range of uses from producing ammonia.	హైడ్రోజన్ నిర్వహణ ఇతర కార్యకలాపాలకు ప్రముఖంగా ఉపయోగపడే ప్రముఖ తేల్చుట పదార్థం గా ఉంది.	హైడ్రోజన్ ఒక ముఖ్యమైన పరిశ్రమ ఇంధనం, ఇది అమోనియా ఉత్పత్తి నుండి వివిధ వినియోగాలను కలిగి ఉంటుంది.	హైడ్రోజన్ ఒక అవసరమైన పారిశ్రామిక ఇంధనం, అమోనియా ఉత్పత్తి చేయడం నుండి వివిధ ఉపయోగాలను కలిగి ఉంటుంది.
Finance Minister Nirmala Sitharaman on Saturday said that regulators would do their job.	ఆదివారం ఆర్థిక మంత్రి నిర్మలా సీతారామన్ ప్రాధికారులు తమ పనులను చేస్తారని చెబుతున్నారు.	శనివారం నాడు ఆర్థిక మంత్రి నిర్మలా సీతారామన్ రెగ్యులేటర్లు తమ పని చేస్తారని చెప్పారు.	శనివారం ఆర్థిక మంత్రి నిర్మలా సీతారామన్ ప్రకటించారు, రెగ్యులేటర్లు వారి పనిని చేస్తారు.
Madras has received a grant of ₹242 crore to do research on laboratory-grown diamonds.	మద్రాస్లో లేబోరేటరీ-ఉత్పన్న హీరాలను గడిచినట్లు పరిశోధనలను చేయడానికి ₹242 కోట్లు అనుదానం పొందింది.	మద్రాస్ ల్యాబొరేటరీ-grown డైమండ్లపై పరిశోధన చేయడానికి ₹242 కోట్ల గ్రాంట్ అందుకుంది.	మద్రాస్ లాబొరేటరీ-పెంచిన వజ్రాలపై పరిశోధన చేయడానికి 242 కోట్ల రూపాయల మంజూరు పొందింది.
Before Rao took leave after the meeting, MGR gently reminded him of the Cauvery water.	సభ నంతరం రావు లీవు తీసుకొన్న ముందు, MGR ఆతనిని కావేరి నీరు గుర్తుంచాడు.	రావు సమావేశం తర్వాత సెలవు తీసుకునే ముందు, ఎంజీఆర్ అతనికి కావేరీ నీటి గురించి సున్నితంగా గుర్తు చేశారు.	సమావేశం తర్వాత రావు సెలవు పెట్టే ముందు, ఎంజీఆర్ కావేరి నీటి గురించి అతనికి మెత్తగా గుర్తు చేశారు.
It is because of this initiative that Tamil Nadu became the centre of higher learning.	ఈ మూలక ప్రారంభం మించినందు తమిళనాడు అధ్యయనం కేంద్రం అయ్యింది.	అదే కారణంగా తమిళనాడు ఉన్నత విద్యాకేంద్రముగా మారింది.	ఈ ఉద్యమం కారణంగా తమిళనాడు ఉన్నత విద్యా కేంద్రంగా మారింది.
However, within minutes after the then Prime Minister intervened.	కానీ, అతను ప్రధానిగా ఉన్న తరువాత నిమిషాల్లో చదవడం తరువాత.	అయితే, అప్పటి ప్రధాన మంత్రి జోక్యం చేసుకున్న కొన్ని నిమిషాల తర్వాత.	అయితే, అప్పటి ప్రధాన మంత్రి జోక్యం చేసిన కొద్ది నిమిషాల్లో.
The initial shock following the Taliban’s seizure of power in Kabul is waning.	కాబుల్లో తాలిబాన్ శక్తి పొందిన తర్వాత మొదటి షాక్ తొందరగా తగ్గిపోతోంది.	కాబూల్‌లో తాలిబాన్ అధికారం స్వాధీనం చేసుకున్న తర్వాత ప్రారంభమైన షాక్ తగ్గుతోంది.	కాబుల్లో తాలిబాన్ అధికారం చేజిక్కిన తరువాత మొదటి షాక్ తగ్గిపోతోంది.
The greatest impact of denial of rights for women in the workforce would be a sharp contraction in the economy.	విముక్తి ఇచ్చని అధికారాలను స్త్రీలకు ఉద్యోగస్థలంలో నిరాకరణ చేస్తే, ఆర్థిక ప్రశాంతత తీవ్రముగా తగ్గిపడుతుంది.	కార్యరంగంలో మహిళల హక్కుల నిరాకరణకు గల అత్యంత ఘనమైన ప్రభావం ఆర్థిక వ్యవస్థలో తీవ్రమైన క్షీణత ఉండటం.	మహిళలకు ఉద్యోగ రంగంలో హక్కుల నిరాకరణ ఆర్థిక వ్యవస్థపై తీవ్రమైన సంకోచానికి దారితీస్తుంది.
The Taliban do not shy from leveraging the issue to gain international attention.	తాలిబాన్ అంతర్జాతీయ గమ్యతను పొందేందుకు ఈ సమస్యను ఉపయోగించడంలో ఆతాగా లేరు.	తాలిబాన్ ఆ సమస్యను అంతర్జాతీయ దృష్టిని ఆకర్షించేందుకు ఉపయోగించుకోవడంలో వెనుకడుగు వేయరు.	తాలిబాన్ అంతర్జాతీయ శ్రద్ధను పొందేందుకు ఈ సమస్యను ఉపయోగించుకునే భయపడటం లేదు.
In Jammu and Kashmir, the enrolment dropped sharply from 1.78 lakh in 2019-20 to 1.31 lakh in 2020-21.	జమ్ము మరియు కాశ్మీర్‌లో, 2019-20 లో 1.78 లక్షల నుండి 2020-21 లో 1.31 లక్షలకు నమోదు తగినది.	జమ్మూ మరియు కాశ్మీర్‌లో, నమోదు సంఖ్య 2019-20లో 1.78 లక్షల నుండి 2020-21లో 1.31 లక్షలకు గణనీయంగా తగ్గింది.	జమ్ము కాశ్మీర్ లో, 2019-20 లో 1.78 లక్షలకు 2020-21 లో 1.31 లక్షలకు నమోదు తీవ్రంగా పడిపోయింది.
Senior advocate Meenakshi Arora made the oral mentioning for early hearing.	సీనియర్ సలాహకారు మీనాక్షి ఆరోరా త్వరలో వినియోగం కోసం మౌఖిక ఉల్లేఖనం చేసారు.	సీనియర్ న్యాయవాది మీనాక్షి అరోరా త్వరితగతిన విచారణ కోసం మౌఖికంగా ప్రస్తావించారు.	సీనియర్ అడ్వొకేట్ మీనాక్షి అరోరా ఆరంభ విన్నపం కోసం మౌఖిక ప్రస్తావన చేసింది.
The State had never forced students out of State schools by restricting hijab.	రాష్ట్రం హిజాబ్ ప్రతిబంధించి విద్యార్థులను రాష్ట్ర పాఠశాలలో నుండి బహిష్కరించలేదు.	రాష్ట్రం హిజాబ్ పరిమితి ద్వారా విద్యార్థులను రాష్ట్ర పాఠశాలల నుంచి బలవంతంగా బయటకు పంపలేదు.	రాష్ట్రం ఎప్పుడూ హిజాబ్ పరిమితులను విధించి విద్యార్థులను రాష్ట్ర పాఠశాలల నుండి బహిష్కరించలేదు.
The patient has the right to refuse to participate in such research projects.	రోగికి అంతా ప్రయోగాలలో పాల్పడం నిరాకరించడానికి హక్కు ఉంది.	ఆ తర్వాత శోధన ప్రాజెక్టుల్లో పాల్గొనడానికి రోగికి తిరస్కరించే హక్కు ఉంది.	ఆ రోగికి ఆయా పరిశోధనా ప్రాజెక్టుల్లో పాల్గొనడానికి నిరాకరించే హక్కు ఉంది.
The field officials should remember it while implementing projects. 	పదాల అధికారులు ప్రాజెక్టులను అమలు చేస్తూ అదనపు గమనాన్ని నెమ్మదించాలి.	ప్రాజెక్టులను అమలు చేసేటప్పుడు ఫీల్డ్ అధికారులు దీన్ని గుర్తుంచుకోవాలి.	ప్రాజెక్టులను అమలు చేసేటప్పుడు ఫీల్డ్ అధికారులు దీన్ని గుర్తుంచుకోవాలి.
Senior officials in the Ministry of Tribal Affairs said a change in the structure had already been approved.	జనాదుల విషయంలో శాఖ ఉన్న ముఖ్య అధికారులు చెప్పారు కొత్త రూపంలో మార్పు అంగీకరించబడింది.	గిరిజన వ్యవహారాల మంత్రిత్వ శాఖలోని సీనియర్ అధికారులు నిర్మాణంలో మార్పు ఇప్పటికే ఆమోదించబడిందని తెలిపారు.	ఆదివాసీ వ్యవహారాల మంత్రిత్వ శాఖలోని సీనియర్ అధికారులు నిర్మాణంలో మార్పు ఇప్పటికే ఆమోదించబడిందని చెప్పారు.
The Bhagwan Mahaveer Foundation has called for applications for the Mahaveer awards.	భగవాన్ మహావీర్ ఫౌండేషన్ మహావీర్ అవార్డుల కోసం అప్లికేషన్లను ప్రకటించింది.	భగవాన్ మహావీర్ ఫౌండేషన్ మహావీర్ అవార్డుల కోసం దరఖాస్తులను ఆహ్వానించింది.	భగవాన్ మహావీర్ ఫౌండేషన్ మహావీర్ అవార్డుల కోసం దరఖాస్తులను కోరుతోంది.
Mr. Yediyurappa resigned as Chief Minister and was succeeded by Basavaraj Bommai in 2020.	శ్రీ యెడియూరప్ప ముఖ్యమంత్రిగా రాజీనామా ఇచ్చారు మరియు 2020లో బసవరాజ్ బొమ్మయికి విలీనం చేశారు.	యడియూరప్ప ముఖ్యమంత్రిగా రాజీనామా చేసి, 2020లో ఆయన స్థానంలో బసవరాజ్ బొమ్మాయి ముఖ్యమంత్రిగా అయ్యారు.	శ్రీ యెడియూరప్ప 2020లో ముఖ్యమంత్రి పదవికి రాజీనామా చేసి, బసవరాజ్ బొమ్మాయి ఆయన స్థానంలో వచ్చారు.
The rescuers had to cut the roof of the lift to bring them out, and nobody was hurt.	రక్షకులు వాల్ట్ నుండి వాచాడానికి మీకు బహిరంగంగా తీయడానికి లిఫ్ట్ యొక్క మేర కట్ చేయాలిగా, మరియు యారు గుర్తుండలేదు.	రక్షకులు వారిని బయటకు తీయడానికి లిఫ్ట్ పైకప్పును కోయాల్సి వచ్చింది, మరియు ఎవరికి కూడా హాని జరగలేదు.	రక్షకులు వారిని బయటకు తీసుకురావడానికి ఎలివేటర్ పైకప్పును కోయాల్సి వచ్చింది, ఎవరూ గాయపడలేదు.
The group claimed another police station attack in Rask that killed one officer on January 10.	గుండు జనాలు జనవరి 10న రాస్క్లో ఒక పోలీసు స్టేషన్ హల్చారి చేశారు.	ఆ గుంపు జనవరి 10న ఒక అధికారి మరణించిన రస్క్‌లో మరో పోలీస్ స్టేషన్ దాడిని తమదిగా ప్రకటించింది.	రాస్క్ లో జనవరి 10 న ఒక అధికారిని చంపిన మరో పోలీస్ స్టేషన్ దాడిని ఆ బృందం పేర్కొంది.
Based on the complaint, an FIR has been registered against Constable Shailendra Singh and three other policemen.	ఫిరు దాఖలా ప్రధానం కామిషనరు షెయిలెంద్ర సింగ్ మరియు మూడు ఇతర పోలీసుల వ్యాధిగారి వ్యతిరేకంగా నమోదు చేయబడింది.	ఫిర్యాదు ఆధారంగా కాన్‌స్టేబుల్ శైలేంద్ర సింగ్ మరియు మరో ముగ్గురు పోలీసులపై ఎఫ్‌ఐఆర్ నమోదు చేయబడింది.	ఫిర్యాదు ఆధారంగా కానిస్టేబుల్ శైలేంద్ర సింగ్, మరో ముగ్గురు పోలీసులపై ఎఫ్ఐఆర్ నమోదు చేయబడింది.
Financial institutions also play a crucial role in tracking the money trails sustaining these networks.	ఆర్థిక సంస్థలు ఈ నెట్వర్కులను ఉపరితల చేయుటకు మార్గదర్శక పాత్రం అదనపు చేస్తున్నాయి.	ఆర్థిక సంస్థలు ఈ నెట్వర్క్‌లను నిలబెట్టే డబ్బు మార్గాలను అన్వేషించడంలో కూడా కీలక పాత్ర పోషిస్తాయి.	ఆర్థిక సంస్థలు కూడా ఈ నెట్‌వర్క్‌లను సమర్థిస్తున్న డబ్బు మార్గాలను ట్రాక్ చేయడంలో కీలక పాత్ర పోషిస్తున్నాయి.
It is laudable that customs duties have been waived on three anti-cancer drugs.	మూడు క్యాన్సర్ రోగనివారణ ఔషధాల మేల్కులు తీసుకున్నట్లు అచ్చని ప్రసంగం కాదు.	మూడు కేన్సర్ నిరోధక ఔషధాలపై ముట్టుసూటి రుసుములను రద్దు చేయడం ప్రశంసనీయమైన విషయం.	మూడు కేన్సర్ వ్యాధి నివారణ మందులపై సరుకు సుంకాలు రద్దు చేయబడినది అభినందనీయం.
Inside the final sprint in the biggest battleground state on the map.	పటంలో అతిపెద్ద యుద్ధభూమిలో అంతిమ స్ప్రింట్లో ఉంది.	నక్షత్రంపై అతి పెద్ద యుద్ధభూమి రాష్ట్రంలో చివరి ఉత్సాహంలో.	మ్యాప్‌లో అతిపెద్ద యుద్ధరంగం రాష్ట్రంలో చివరి స్ప్రింట్ లో లోపల.
All eyes are on America as an uncertain world awaits election result.	అమెరికా పై అన్ని కనులు చూస్తున్నాయి అని అనిశ్చితమైన ప్రపంచము ఎన్నికల ఫలితానికి ఎదురుచూస్తున్నది.	అనిశ్చితమైన ప్రపంచం ఎన్నికల ఫలితాలను ఎదురు చూస్తున్నప్పుడు, అమెరికాపై అందరి చూపులు ఉన్నాయి.	అమెరికా ఎన్నికల ఫలితాన్ని అనిశ్చిత ప్రపంచం ఆసక్తిగా ఎదురుచున్నది.
Twitch faces criticism over Israel-Gaza war content on platform.	ట్విచ్ వినితంగా ఇస్రాయెల్-గాజా యుద్ధ విషయం ప్లాట్ఫారంలో విమర్శ చేస్తుంది.	ట్విచ్ ప్లాట్‌ఫారమ్‌పై ఇజ్రాయిల్-గాజా యుద్ధ కంటెంట్‌కు సంబంధించిన విమర్శలు ఎదుర్కొంటోంది.	ట్విచ్ ఇజ్రాయెల్-గాజా యుద్ధ కంటెంట్ ప్లాట్‌ఫారంలో విమర్శలను ఎదుర్కొంటున్నది.
North Korea fires multiple ballistic missiles toward the sea ahead of U.S. election.	ఉత్తర కొరియా యు.ఎస్. ఎన్నికల ముందు సముద్రంకు విరుచున్న అనేక బాలిస్టిక్ మిసైల్స్ పెట్టుతుంది.	ఉత్తర కొరియా యుఎస్ ఎన్నికలకు ముందు సముద్రం వైపు పలువురు బాలిస్టిక్ క్షిపణులను ప్రయోగించింది.	యుఎస్ ఎన్నికల ముందు ఉత్తర కొరియా సముద్రం వైపు బహుళ బాలిస్టిక్ క్షిపణులను ప్రయోగించింది.
Singapore Airlines will add first class, revamp cabins for longest flights.	సింగపూర్ ఎయర్లైన్స్ లొంగ్ ఫ్లైట్స్కు ఫస్ట్ క్లాస్ నమోదు చేస్తుంది, క్యాబిన్స్ నవీకరణ చేస్తుంది.	సింగపూర్ ఎయిర్‌లైన్స్ దీర్ఘకాలిక ప్రయాణాల కోసం ఫస్ట్ క్లాస్‌ను చేర్చును, కేబిన్లను పునర్నిర్మించును.	సింగపూర్ ఎయిర్లైన్స్ తన అతి పొడవైన ప్రయాణాలకు మొదటి తరగతిని జోడించనున్నది, కేబిన్లను పునర్నిర్మించనున్నది.
Priyanka Chopra Jonas and Nick Jonas celebrate 'Diwaloween,' Diwali and Halloween mashup.	ప్రియాంకా చోప్రా జోనాస్ మరియు నిక్ జోనాస్ 'దివాలోవీన్' పండుగను ఆచరించారు, దీపావళి మరియు హాలోవీన్ మ్యాషప్.	ప్రియాంక చోప్రా జోనాస్ మరియు నిక్ జోనాస్ 'దివాలోవీన్,' దివాళి మరియు హాలోవీన్ మిక్స్‌ను జరుపుకుంటున్నారు.	ప్రియాంక చోప్రా జోనాస్ మరియు నిక్ జోనాస్ 'దీవాలోవీన్' జరుపుకుంటున్నారు, దీపావళి మరియు హాలోవీన్ మిశ్రమం.
Pennsylvania officials denounce Halloween float appearing to depict Harris tied to golf cart.	పెన్సిల్వేనియా అధికారులు హాలోవీన్ పరికరంతో హ్యారిస్ను గాల్ఫ్ కార్టుకు కట్టినట్టు వ్యక్తిగా చూపించేందుకు ఖండనా చేస్తున్నారు.	పెన్సిల్వేనియా అధికారులు హ్యాలొవీన్ ఫ్లోట్‌పై హారిస్‌ను గాల్ఫ్ కార్ట్‌కు కట్టివేసినట్లు కనిపించడాన్ని ఖండించారు.	పెన్సిల్వేనియా అధికారులు హాలోవీన్ ఫ్లోట్ హారిస్ గోల్ఫ్ కార్ట్ కు కట్టివేయబడినట్లు కనిపిస్తున్నది అని ఖండిస్తున్నారు.
Elon Musk's election-doubting posts shared 9 times more than his less extreme election content.	ఎలాన్ మస్క్ ఎన్నికలను సందేహపడింది పోస్టులు కన్నా అతిక్రమాత్మకంగా ఉన్నవి కనుగులు తక్కువగా 9 సార్లు భాగం చేశారు.	ఎలాన్ మస్క్‌ ఎన్నికలపై అనుమానం వ్యక్తం చేసిన పోస్ట్‌లు ఇతర సాధారణ ఎన్నికల కంటెంట్‌తో పోలిస్తే 9 రెట్లు ఎక్కువగా షేర్ చేయబడ్డాయి.	ఎలాన్ మస్క్ యొక్క ఎన్నికల సందేహాలు ఆయన తక్కువ అతివాద ఎన్నికల విషయాలను 9 సార్లు పంచుకున్నాయి.
Americans eye the economy from kitchen tables and hourly jobs as they plan their votes.	అమెరికన్స్ తమ ఓటులను నియోజిస్తున్నప్పుడు అమరావరి అరమానికి ముఖ్యంగా కిచన్ టేబులు మరియు అవధు ఉద్యోగాలి నుండి పేర్కొని ప్లాన్ చేస్తున్నారు.	అమెరికన్లు తమ ఓటు ప్రణాళికలను సిద్ధం చేసుకుంటూ, వంటగదుల టేబుల్స్ మరియు గంట వారీ ఉద్యోగాల నుండి ఆర్థిక వ్యవస్థను పరిశీలిస్తున్నారు.	అమెరికన్స్ వారు తమ ఓట్లను ప్లాన్ చేసేటప్పుడు వారు కిచెన్ టేబుల్స్ నుండి ఆర్థిక వ్యవస్థను చూస్తున్నారు, అవరు తమ సగటు ఉద్యోగాలను ప్లాన్ చేస్తున్నారు.
Quincy Jones, musical maestro and entertainment industry titan, dies at 91.	క్విన్సీ జోన్స్, సంగీత మహాసాగరం మరియు వినోద పరిశ్రమ ముఖ్యస్థుడు, 91 సంవత్సరాల వయసుతో మృతి పొందడం.	సంగీత మాస్ట్రో మరియు వినోద పరిశ్రమ దిగ్గజం క్విన్‌సీ జోన్స్ 91 ఏళ్ల వయసులో మరణించారు.	క్విన్సీ జోన్స్, సంగీత మేస్ట్రో మరియు వినోద పరిశ్రమ భీముడు, 91 వ ఏట మరణించాడు.
Proud Boys claim they'll be at polling places as Trump ups violent rhetoric and fraud claims	ప్రౌడ్ బాయ్స్ అభిమానం తో ట్రంప్ ఉగ్రంగా మాట్లాడని మరియు ఫ్రాడ్ ప్రమాణాలను పెరిగినందుకు పోలింగ్ ప్లేసుల్లో ఉన్నారని ప్రకటిస్తున్నారు.	గర్వపడే అబ్బాయిలు ట్రంప్ హింసాత్మక ప్రస్తావనలు మరియు మోసం ఆరోపణలను పెంచినప్పుడు, ఎన్నికల కేంద్రాలలో ఉంటామని చెబుతున్నారు.	ట్రంప్ హింసాత్మక వాక్యాలు, మోసం ఆరోపణలు పెంచుతున్నప్పుడు ప్రౌడ్ బాయ్స్ పోలింగ్ స్థలాల వద్ద ఉంటామని చెబుతున్నారు.
One of the police officers stumbled to the ground when the driver applied brakes and attempted to strike him.	డ్రైవరు బ్రేక్స్ చేసి పోలీసు అధికారి గుడికి పడినప్పుడు అతను ఆక్రమించడానికి ప్రయత్నించడం వలన భూమిపై పడినాడు.	ఒక పోలీసు అధికారి బ్రేకులు వేస్తూ అతనిపై దాడి చేయడానికి ప్రయత్నించినప్పుడు నేలపై పడిపోయాడు.	ఒక పోలీసు అధికారి డ్రైవరు బ్రేక్స్ అప్లై చేసి అతన్ని కొట్టడానికి ప్రయత్నించినప్పుడు నేల కూలిపోయాడు.
The authorities confirmed they have identified the vehicle's owner and expect to make an arrest shortly.	అధికారులు గాడి యొక్క యజమానిని గుర్తించారు మరియు త్వరలో ఒక అరెస్టు చేయడానికి ఆశిస్తున్నారని ధృవీకరించారు.	అధికారులు వాహనం యజమానిని గుర్తించారని, మరియు త్వరలో అరెస్టు చేస్తారని ధృవీకరించారు.	అధికారులు వాహనం యజమానిని గుర్తించారు, త్వరలో అరెస్టు చేయడానికి ఆశిస్తున్నారు.
The Chhatrapati Shivaji statue in the Arabian Sea off the Mumbai coast is referred to as a precedent for the proposed pen memorial.	ముంబై తీరంలో అరేబియన్ సముద్రలో ఉన్న ఛత్రపతి శివాజీ ప్రతిమ ప్రస్తావిత పెన్ స్మారకంకు మూలంగా ఉందని చెప్పబడుతుంది.	ముంబయి తీరానికి సమీపంలో అరేబియా సముద్రంలో ఉన్న ఛత్రపతి శివాజీ విగ్రహాన్ని ప్రతిపాదిత పెన్ మెమోరియల్ కోసం ఒక నిదర్శనంగా పేర్కొంటారు.	ముంబై తీరం నుండి అరబ్బీ సముద్రంలో ఉన్న ఛత్రపతి శివాజీ విగ్రహం ప్రతిపాదిత పెన్ స్మారక కోసం ఒక ఆదర్శంగా పేర్కొనబడుతుంది.
Several political parties have opposed the pen memorial in the proposed location.	కొన్ని రాజకీయ పక్షాలు సూచించటం ద్వారా ఆలోచించిన స్థలంలో పెన్ స్మారకంను విరోధించారు.	ముఖ్యమైన రాజకీయ పక్షాలు ప్రతిపాదిత ప్రదేశంలో కలం స్మారక చిహ్నాన్ని వ్యతిరేకించాయి.	ప్రతిపాదిత స్థలంలో పెన్ స్మారకానికి అనేక రాజకీయ పార్టీలు వ్యతిరేకించాయి.
They have not taken into consideration the rainfall data of 2015 or years thereafter. 	వారు 2015 లో లేదా తరువాత ఏ సంవత్సరాల వరకు వర్షాల డేటాను పరిగణించలేదు.	వారు 2015 లేదా ఆ తర్వాత సంవత్సరాల వర్షపాతం డేటాను పరిగణనలోకి తీసుకోలేదు.	వారు 2015 లేదా ఆ తరువాతి సంవత్సరాల వర్షపాత డేటాను పరిగణలోకి తీసుకోలేదు.
The museum has been equipped with multimedia content, QR codes and holograms.	మ్యూజియంలో మల్టీమీడియా విషయాలు, QR కోడ్లు మరియు హోలోగ్రామ్లతో అద్దులు పెట్టబడింది.	సంగ్రహాలయం మల్టీమీడియా కంటెంట్, QR కోడ్‌లు మరియు హోలోగ్రామ్‌లతో సజ్జం చేయబడింది.	మ్యూజియం మల్టీమీడియా కంటెంట్, క్యూఆర్ కోడ్లు, హాలోగ్రామ్స్ తో సజ్జయ్యంగా ఉంది.
The ninth phase of the excavations would begin later this month, said officials.	అధికారులు చెప్పినంత ఖనివాడుల తొముగు ఖని నిలయం ఈ నెల వద్ద ప్రారంభించబోతుంది.	అధికారులు తెలిపినట్లు తవ్వకాల తొమ్మిదవ దశ ఈ నెల చివర్లో ప్రారంభమవుతుంది.	ఈ నెల చివరిలో తవ్వకాల తొమ్మిదో దశ ప్రారంభం కానుంది, అధికారులు చెప్పారు.
Mr. Reddy is a close relative of Taraka Ratna's wife Alekya Reddy.	శ్రీ రెడ్డి టారక రత్నా భార్య అలేఖ్య రెడ్డి యొక్క సన్నగా సంబంధితుడు.	మిస్టర్ రెడ్డి, తారకరత్న భార్య అలేక్య రెడ్డి కి సన్నిహిత బంధువు.	తారక రత్న భార్య అలేఖ్యా రెడ్డికి సన్నిహిత బంధువు రెడ్డి గారు.
This betrays an inexplicable hostility towards knowledge creation of all kinds. 	ఇది అన్ని రకాల ప్రజ్ఞా సృష్టికి అప్రమేయ శత్రుతను వెలువడిస్తుంది.	ఇది అన్ని రకాల జ్ఞాన సృష్టి పట్ల అర్థంచేసుకోలేని శత్రుత్వాన్ని వెల్లడిస్తుంది.	అన్ని రకాల జ్ఞాన సృష్టికి విచిత్రమైన వైరుధ్యాన్ని బహిర్గతం చేస్తుంది.
The second is what he calls alienation from the process of labour.	రెండవ అది తన క్రియా నిషేధం అనేది అన్నాడు.	రెండవది ఆయన శ్రమ ప్రక్రియ నుండి వేరుపాటు అని పిలుస్తాడు.	ఆ రెండవది ఆయన పని ప్రక్రియ నుండి విదేశీకరణను అంటారు.
In the process, Marx argued, workers become miserable.	ప్రక్రియ లో, మార్క్స్ వాదించారు, కార్మికులు దుఃఖితమవుతారు.	ఈ ప్రక్రియలో, కార్మికులు దయనీయులుగా మారుతారని మార్క్స్ వాదించారు.	ప్రక్రియలో, మార్క్స్ వాదించాడు, కార్మికులు దుఃఖంగా అవుతారు.
He asked the people to compare the scale of development in the adjoining Assam during eight years of BJP rule.	అస్సాంలో బిజెపి రాజానికి ఎనిమిది సంవత్సరాలు ఉండిన సమయంలో అస్సాంలో అభివృద్ధి స్కేల్ ను తులనగా చెయ్యడానికి వారు ప్రజలను అడిగాడు.	అతను ప్రజలను ఆరు ఏళ్లు BJP పాలనలో ఉన్న సమీపంలోని అస్సాంలో అభివృద్ధి స్థాయిని పోల్చమని కోరాడు.	ఆయన బిజెపి పాలనలో ఎనిమిది సంవత్సరాల్లో అస్సాంలో అభివృద్ధి స్థాయిని పోల్చమని ప్రజలను కోరారు.
The DMK MP also said that the Budget presented by Union Finance Minister Nirmala Sitharaman had neglected sectors such as education, health and agriculture.	డిఎంకే ఎంపీ కూడా సాంసద ఆర్థ మంత్రి నిర్మల సీతారామన్ అందించిన బడ్జెట్ లో విద్య, ఆరోగ్య మరియు వ్యవసాయ వంటి ఖాళీలు ఉపేక్షించిందని కూడా చెప్పారు.	డీఎంకే ఎంపీ కూడా కేంద్ర ఆర్థిక మంత్రి నిర్మలా సీతారామన్ సమర్పించిన బడ్జెట్ విద్య, ఆరోగ్యం మరియు వ్యవసాయం వంటి రంగాలను నిర్లక్ష్యం చేసిందని అన్నారు.	డీఎంకే ఎంపీ ఇంకా కేంద్ర ఆర్థిక మంత్రి నిర్మలా సీతారామన్ ప్రాంతీయ బడ్జెట్ విద్య, ఆరోగ్యం, వ్యవసాయం వంటి రంగాలను విస్మరించిందని చెప్పారు.
The accident took place around 3 p.m. on a State highway close to Korar village.	అపఘాతం కొరార్ గ్రామం కొరికలో ఉన్న రాష్ట్ర రహదారిలో ఉన్న ప్రాంగనం 3 గంటల సమయంలో జరిగింది.	ఆపద మధ్యాహ్నం 3 గంటల సమయానికి కొరార్ గ్రామం సమీపంలోని రాష్ట్ర రహదారిపై చోటు చేసుకుంది.	కోరార్ గ్రామం దగ్గరలోని రాష్ట్ర రహదారిపై 3 వ గంటకు సమీపంలో ఆకస్మికం జరిగింది.
Both the survivors are being treated at a hospital in Raipur.	రాయపురలో ఆస్థివాదులందరూ ఆస్పత్రిలో చికిత్స పొందుతున్నారు.	రాయపూర్‌లోని ఒక ఆసుపత్రిలో ఇద్దరు బతికిన వారు చికిత్స పొందుతున్నారు.	రాయపూర్ లోని ఒక ఆస్పత్రిలో రెండు బతికుండగా ఉన్నవారు చికిత్స పొందుతున్నారు.
Chief Minister Bhupesh Baghel took to Twitter to express grief over the accident.	ముఖ్యమంత్రి భూపేష్ బాగేల్ అక్సిడెంట్ పై దుఃఖాన్ని వ్యక్తం చేయడానికి ట్విటర్ ఉపయోగించారు.	ముఖ్యమంత్రి భూపేష్ బఘేల్ ప్రమాదంపై విచారం వ్యక్తం చేస్తూ ట్విట్టర్‌లో స్పందించారు.	ముఖ్యమంత్రి భూపేష్ బఘేల్ ఆకస్మిక సంఘటనపై సంతాపం వ్యక్తం చేసేందుకు ట్విట్టర్ వాడారు.
The Indian Institute of Technology Madras (IIT-M) Research Park hosted a competition for children.	ఇండియన్ ఇన్స్టిట్యూట్ ఆఫ్ టెక్నాలజీ మద్రాస్ (IIT-M) రిసర్చ్ పార్క్ వాటికి చిల్డ్రన్లకు ఒక పోటీకి ఆయోజించింది.	భారతీయ ఇన్స్టిట్యూట్ ఆఫ్ టెక్నాలజీ మద్రాస్ (IIT-M) రీసెర్చ్ పార్క్ పిల్లల కోసం ఒక పోటీనిర్వహించింది.	భారతీయ సాంకేతిక విశ్వవిద్యాలయం మద్రాస్ (ఐఐటీ-ఎం) పరిశోధనా పార్క్ పిల్లల కొరకు పోటీని నిర్వహించింది.
"External affairs minister S Jaishankar on Tuesday expressed concern over the attack on a Hindu temple in Canada, describing the incident as ""deeply concerning."	"మంగళవారం బహిరాంగ ప్రవాహ మంత్రి ఎస్ జయశంకర్ కెనడాలో ఒక హిందూ దేవాలయంపై దాడి జరిగినదను ఆఘాతకరంగా చెప్పి, ఈ ఘటనను ""గంభీరంగా ఆశంసించగా"" చెప్పాడు."	"బాహ్య వ్యవహారాల మంత్రి ఎస్. జైశంకర్ మంగళవారం కెనడాలో హిందూ దేవాలయంపై జరిగిన దాడి పట్ల ఆందోళన వ్యక్తం చేశారు, ఈ ఘటనను ""లోతైన ఆందోళనకరమైనది""గా వర్ణించారు."	"కెనడాలో హిందూ దేవాలయంపై జరిగిన దాడిపై విదేశాంగ మంత్రి ఎస్ జైశంకర్ మంగళవారం ఆందోళన వ్యక్తం చేసి, ఈ సంఘటనను ""చాలా ఆందోళనకరం"" అని వర్ణించారు."
Modi condemns violence after Canada temple inciden.	కెనడా దేవాలయ ఘటన తరువాత మోదీ హింసాన్ని ఖండిస్తున్నారు.	కెనడా ఆలయం ఘటన అనంతరం మోదీ హింసను ఖండించారు.	కానాడా ఆలయ సంఘటన తరువాత హింసను మోదీ ఖండిస్తున్నారు.
Mr Nijjar had been a vocal supporter of the Khalistan movement and publicly campaigned for it.	శ్రీ నిజ్జార్ ఖాలిస్తాన్ చలనంకు ప్రత్యక్ష మద్దతుగా ఉన్నాడు మరియు ప్రజాలకు పబ్లిక్‌గా ప్రచారం చేశాడు.	నిజ్జర్ గారు ఖలిస్తాన్ ఉద్యమానికి గట్టిగా మద్దతు ఇచ్చినవారు మరియు ప్రజల సమక్షంలో దాని కోసం ప్రచారం చేశారు.	నిజ్జార్ గారు ఖలిస్తాన్ ఉద్యమానికి స్పష్టంగా మద్దతు ఇచ్చారు మరియు దానికోసం ప్రజాస్వామ్యంగా ప్రచారం చేశారు.
Bangladesh steps up repayments to Adani to avoid power supply cu.	బంగ్లాదేశ్ అడానికి శక్తి సరఫరాలను కట్టడానికి దగ్గర ప్రతిపాదనలను పెంచేది.	బంగ్లాదేశ్ విద్యుత్ సరఫరా లోపం నివారించేందుకు అదానీకి చెల్లింపులను పెంచుతుంది.	బంగ్లాదేశ్ అదానికి విద్యుత్ సరఫరా కొరత నివారణ కోసం చెల్లింపులను పెంచుతోంది.
The country is already suffering from increased power shortages in rural areas.	దేశం ఇప్పటికే గ్రామీణ ప్రాంతాల్లో అభివృద్ధి చేతనం కనుక వలన విద్యుత్ లేదాకి కొట్టలేదు.	దేశం ఇప్పటికే గ్రామీణ ప్రాంతాల్లో పెరిగిన విద్యుత్తు కొరతలతో బాధపడుతోంది.	గ్రామీణ ప్రాంతాల్లో పెరిగిన విద్యుత్ లోపాలతో దేశం ఇప్పటికే బాధపడుతోంది.
Officials said 44 people were on board when the driver lost control and the bus fell into a 50m-deep ditch in Marchula, located in the state’s Almora district.	అధికారులు చెప్పారు మార్చులలో నడిచిన డ్రైవర్ కంట్రోల్ కోలుచేసినప్పుడు బస్ వీళ్లను 50 మీటర్ లగతే అంబుజాలలో పడిపోయింది, ఆ సమయంలో అల్మోరా జిల్లాలో ఉండే స్థితి లో ఉన్నట్లు ఉన్నారు.	అధికారులు తెలిపిన ప్రకారం, ఆ రాష్ట్రంలోని ఆల్మోరా జిల్లాలోని మార్చుల వద్ద డ్రైవర్ నియంత్రణ కోల్పోవడంతో బస్సు 50 మీటర్ల లోతైన కందకంలో పడిపోయినప్పుడు బస్సులో 44మంది ఉన్నారు.	అధికారులు చెప్పినట్లు మార్చులాలోని అల్మోరా జిల్లాలో డ్రైవరు నియంత్రణ కోల్పోయినప్పుడు బస్సు 50 మీటర్ల లోతున్న కందకంలో పడిపోయింది, అందులో 44 మంది ప్రయాణీకులు ఉన్నారు.
Uttarakhand's Chief Minister Pushkar Singh Dhami has also announced financial assistance for the victims and their families.	ఉత్తరాఖండ్ ముఖ్యమంత్రి పుష్కర్ సింగ్ ధామి కూడా ఆపిన ఆర్థిక సహాయం విక్టిమ్స్ మరియు వారి కుటుంబాలకు.	ఉత్తరాఖండ్ ముఖ్యమంత్రి పుష్కర్ సింగ్ ధామి బాధితులు మరియు వారి కుటుంబాలకు ఆర్థిక సహాయం ప్రకటించారు.	ఉత్తరాఖండ్ ముఖ్యమంత్రి పుష్కర్ సింగ్ ధామి కూడా బాధితులకు మరియు వారి కుటుంబాలకు ఆర్థిక సహాయం ప్రకటించారు.
Our scientists used it as an incentive to develop their own technology.	మా వైజ్ఞానికులు తమ స్వంత సాంకేతికం ప్రసాధనకు ఉపయోగించారు.	మన శాస్త్రవేత్తలు తమ స్వంత సాంకేతికతను అభివృద్ధి చేయడానికి ప్రోత్సాహకంగా దీన్ని ఉపయోగించారు.	మన శాస్త్రవేత్తలు దాన్ని తమ స్వంత సాంకేతికతను అభివృద్ధి చేసేందుకు ప్రేరణగా ఉపయోగించారు.
Mylswamy Annadurai, chief of India’s first and second Moon missions and Mars mission, told the BBC that Isro employs far fewer people and pays lower salaries, which makes Indian projects competitive.	భారతదేశంలో మొదటి మరియు రెండవ చంద్ర మిషన్ల మరియు మంగళం మిషన్ల ముఖ్య మైస్వామి అన్నాదురై, BBC కి చెప్పినట్లు ఇస్రో అద్భుతమైన సంఖ్యలో ఉద్యోగులను నియమిస్తుందని, అలాగే ఇండియన్ ప్రాజెక్టుల ప్రత్యేకమగును చేస్తుందని చెప్పాడు.	భారతదేశ మొదటి మరియు రెండవ చంద్ర మిషన్‌లు మరియు మార్స్ మిషన్‌ల చీఫ్ అయిన మైల్స్వామి అన్నదురై, Isro తక్కువ మంది ఉద్యోగులను నియమిస్తుందని మరియు తక్కువ జీతాలు చెల్లిస్తుందని, ఇది భారతీయ ప్రాజెక్టులను పోటీగా ఉంచుతుందని BBCకి చెప్పారు.	మైల్స్వామి అన్నదురై, భారతదేశం యొక్క మొదటి మరియు రెండవ చంద్ర మిషన్లు మరియు మార్స్ మిషన్ యొక్క ప్రధాని, బీబీసీకి చెప్పారు ఇస్రో తక్కువ సంఖ్యలో ఉద్యోగులను నియమిస్తుంది మరియు తక్కువ జీతాలను చెల్లిస్తుంది, ఇది భారతీయ ప్రాజెక్టులను పోటీతత్వంలో ఉంచుతుంది.
Ex-district president of Bajrang Dal Gurgaon held for shooting at Gurgaon man.	గుర్గావులో గుర్గావు మనిషిని గుండుపెట్టడానికి బజ్రంగ్ దళ్ గుర్గావు జిల్లా అధ్యక్షుడు అరెస్టు చేసినాడు.	గురుగ్రామ్ వ్యక్తిపై కాల్పులు జరిపిన బజరంగ్ దళ్ గురుగ్రామ్ మాజీ జిల్లా అధ్యక్షుడు అరెస్టు.	గుర్గావ్ బజ్రంగ్ దళ్ మాజీ జిల్లా అధ్యక్షుడు గుర్గావ్ వ్యక్తిపై కాల్పులు జరిపినందుకు అరెస్ట్ అయ్యాడు.
The legendary Bob Khathing led the expedition to peacefully integrate Tawang into India.	దీర్ఘాయుధం బాబ్ ఖాథింగ్ తావాంగ్ను భారతదేశంలో శాంతిగా లముషులో ముడుపు చేయడానికి ఎగ్జిపేడిషన్ను లెడ్ చేశాడు.	ప్రముఖ బాబ్ ఖాతింగ్ తవాంగ్‌ను భారతదేశంలో శాంతియుతంగా కలిపేందుకు యాత్రను నడిపించారు.	భారతదేశంలో తావాంగ్ ను శాంతియుతంగా విలీనం చేసే ప్రయాణాన్ని కింగ్ బాబ్ ఖాతింగ్ నాయకత్వం వహించారు.
In 1939, after the Second World War broke out, Khathing joined the Indian Army and got an Emergency Commission as an officer.	1939 లో, రెండవ ప్రపంచ యుద్ధం ప్రారంభమైన తరువాత, ఖాతింగ్ భారత సేనలో చేరాడు మరియు ఒక ఆపత్కాల కమీషన్ వంటి అధికారి గా లభించాడు.	1939లో, రెండవ ప్రపంచ యుద్ధం ప్రారంభమైన తర్వాత, ఖథింగ్ భారత సైన్యంలో చేరి అధికారి గా ఎమర్జెన్సీ కమిషన్ పొందారు.	1939లో రెండవ ప్రపంచ యుద్ధం ప్రారంభమైన తరువాత, ఖాతింగ్ భారతీయ సైన్యంలో చేరి అత్యవసర కమిషన్ ను అధికారిగా పొందాడు.
At the end of the Second World War, the Emergency Commissioned officers in the Army were demobilised.	ద్వితీయ ప్రపంచ యుద్ధం ముగిసిన తర్వాత, సేనలో ఎమర్జెన్సీ కమిషన్ అధికారులు డీమొబిలైజ్ చేయబడ్డారు.	రెండవ ప్రపంచ యుద్ధం ముగిసినప్పుడు, ఆర్మీలోని ఎమర్జెన్సీ కమిషన్‌డ్ అధికారులను పునర్వ్యవస్థీకరించారు.	రెండవ ప్రపంచ యుద్ధం ముగింపులో, సైన్యంలోని జరూరీ కమిషన్ అధికారులు విడుదల చేయబడ్డారు.
Most of the senior cricketers were far from their best, especially against New Zealand.	అత్యధిక ప్రముఖ క్రికెటర్లు తమ ఉత్తమం నుండి దూరంగా ఉండున్నారు, ముఖ్యంగా న్యూజిలాండ్తో.	మొత్తం సీనియర్ క్రికెటర్లు తమ అత్యుత్తమ స్థితి నుండి దూరంగా ఉన్నారు, ప్రత్యేకంగా న్యూజిలాండ్‌పై.	అధిక సీనియర్ క్రికెటర్లు వారి ఉత్తమం నుంచి చాలా దూరంలో ఉన్నారు, న్యూజిలాండ్ తో ప్రత్యేకించి.
