src	gpt_3_5_trans	gpt_4o_trans	ollama_trans
JMM says Soren's helicopter take off delayed over PM's security protocol, writes to President Murmu	JMM ప్రధాని సురేన్ హెలికాప్టర్ పరిగణనల వారిని నమగా ప్రయాణం ప్రారంభించడం విలంబించింది, రష్ట్రపతి మూర్ముకు రాయలు చేశాడు.	జేఎమ్మ్ అంటున్నారు సొరెన్ గారి హెలికాప్టర్ టేక్ ఆఫ్ ప్రధానమంత్రి గారి భద్రతా నిబంధనల కారణంగా ఆలస్యం అయిందని, రాష్ట్రపతి ముర్ము గారికి లేఖ రాశారు.	జేఎంఎం చెబుతున్నది, ప్రధాని భద్రతా ప్రోటోకాల్ కారణంగా సోరెన్ హెలికాప్టర్ టేకాఫ్ ఆలస్యం అయింది, రాష్ట్రపతి ముర్ములకు లేఖ వ్రాసారు.
The king who defied the British: Uncovering the tale of Pazhassi raja’s rebellion	బ్రిటిష్ అనుమతి చేయని రాజా: పాఝస్సి రాజా తీరును ప్రకటించే కథని వెలుపలు లేదు.	బ్రిటిష్‌వారిని వ్యతిరేకించిన రాజు: పഴశ్శి రాజు తిరుగుబాటు కథను వెలికితీయడం.	బ్రిటిష్ వారిని ఎదిరించిన రాజులు: పాళయి రాజాల తిరుగుబాటు కథను వెలికితీస్తున్నారు.
Vinesh Phogat's retirement U-turn predicted after her latest Instagram post creates buzz on social media	వినేష్ ఫోగట్ తన ఇటర్నెట్ పోస్టుతో సోషల్ మీడియాలో గడపార్ధం సృష్టించిన తరువాత ఆమె నివృత్తి యూ-టర్న్ అంటూ భవిష్యవాణన చేశారని ఊహించబడుతుంది.	వినేశ్ ఫోగాట్ తన తాజా ఇన్‌స్టాగ్రామ్ పోస్ట్‌తో సోషల్ మీడియాలో సంచలనం సృష్టించిన తరువాత, ఆమె రిటైర్మెంట్ నిర్ణయంలో మార్పు సంభవించే అవకాశం ఉందని అంచనా వేస్తున్నారు.	వినేష్ ఫోగట్ గారు యొక్క రిటైర్మెంట్ యు-టర్న్ ఆమె లేటెస్ట్ ఇన్స్టాగ్రామ్ పోస్ట్ సోషల్ మీడియాలో క్రేజ్ సృష్టించింది.
The Pennsylvania push: Kamala Harris, Donald Trump spend final campaign hours in swing state	పెన్సిల్వేనియా పుష్: కమలా హారిస్, డొనాల్డ్ ట్రంప్ అంతిమ ప్రచార గంటలు స్వింగ్ రాష్ట్రంలో చల్లగా కలిపివేశారు.	పెన్సిల్వేనియా ప్రచారం: కమలా హారిస్, డొనాల్డ్ ట్రంప్ స్వింగ్ రాష్ట్రంలో తుదిగంటల ప్రచారంలో పాల్గొన్నారు.	పెన్సిల్వేనియా పుష్: కమలా హారిస్, డొనాల్డ్ ట్రంప్ గారు స్వింగ్ స్టేట్ లో చివరి ప్రచార గంటలు గడిపారు.
Delhi engulfed in smog, toxic foam in Yamuna: Pics that capture national capital's pollution woes	దిల్లీ స్మాగ్లో ముందుగాలు మేకలు తీసుకున్నది, యమునాలో విషపరచే ఫోమ్: జాతీయ రాజధాని కాలుష్యాలను గ్రహించే చిత్రాలు.	దిల్లీ పొగమంచుతో నిండిపోయింది, యమునా నదిలో విషపూరిత నురుగు: జాతీయ రాజధానిలో కాలుష్య సమస్యలను చూపించే చిత్రాలు.	ఢిల్లీ స్మోగ్ లో మునిగిపోయింది, యమునాలో విషపూరిత ఫోమ్: జాతీయ రాజధాని యొక్క కాలుష్య సమస్యలను చిత్రీకరించే చిత్రాలు.
Will Muslim boycott of Kamala send Trump to the White House?	ముస్లిం కమలకు బాయ్కాట్ చేయండిగా, ట్రంప్ను వైట్ హౌస్కు పంపిస్తుందా?	కమలాను ముస్లిం బహిష్కరణ ట్రంప్‌ను వైట్ హౌస్‌కు పంపిస్తుందా?	ముస్లిములు కమలాను బహిష్కరిస్తే ట్రంప్ వైట్ హౌస్ చేరుకుంటారా?
Why Indian batters are struggling against left-arm spin	భారతీయ బ్యాటర్లు ఎడమ చుక్క డైనమోతో పోరాడతారా?	భారత బ్యాటర్లు ఎడమచేతి స్పిన్‌ బౌలింగ్‌ ముందు ఎందుకు ఇబ్బంది పడుతున్నారు?	భారతీయ బ్యాటర్లు ఎడమ-చేతి స్పిన్ కి ఎందుకు ఇబ్బంది పడుతున్నారు
JD Vance calls Kamala Harris 'trash' at Atlanta rally: 'In 2 days we're taking out the garbage'	JD Vance అట్లాంటా సభలో Kamala Harrisని 'సాక్ష్యం' అంటున్నాడు: '2 రోజుల్లో మార్పులు తీస్తున్నాం'	JD వాన్స్ అట్లాంటా ర్యాలీలో కమల హ్యారిస్‌ను 'తక్కువ స్థాయి'గా పిలిచారు: 'ఇంకా 2 రోజుల్లో మేము తిరస్కారాన్ని బయటకు తీస్తున్నాం'.	జేడ్ వాన్స్ అట్లాంటా ర్యాలీలో కమలా హారిస్ ను 'చెత్త' అని పిలుస్తున్నారు: '2 రోజుల్లో మేము చెత్తను తొలగిస్తున్నాము'
Meghan and Harry feel life in US hasn't been what they expected: Ex-staff	మెగన్ మరియు హ్యారీ అమెరికాలో జీవితం అంటే అవారానికి కావాలంటూ అనుకోవటం లేదని అనుభవిస్తున్నారు: మునుపు స్టాఫ్	మెఘన్ మరియు హ్యారీ అనుభవిస్తున్న అమెరికాలోని జీవితం వారు ఆశించినట్లు లేకపోయిందని మాజీ సిబ్బంది పేర్కొన్నారు.	మెఘాన్, హారీ అమెరికాలో జీవితం వారికి ఆశించినది కాదని మాజీ సిబ్బంది చెబుతున్నారు.
Elon Musk reacts to reports that he could be deported for immigration violation	ఆస్ట్రలియా ఇలాంటి సరికొత్త విధిని భయపడే అవకాశం ఉంటుందని ప్రకటిస్తున్న ఎలాన్ మస్క్ ప్రతిపాదించాడు.	ఎలాన్ మస్క్ గారిని వలస ఉల్లంఘన కారణంగా దేశ బహిష్కరణ చేయవచ్చని వచ్చిన నివేదికలపై ఆయన స్పందించారు.	ఎలాన్ మస్క్ వారు ఇమ్మిగ్రేషన్ ఉల్లంఘన కారణంగా వారిని దేశం నుండి తొలగించవచ్చునని వార్తలకు స్పందిస్తున్నారు.
How China is lessening its reliance on helium sourced from US	చైనా ఎలా అమెరికా నుండి దొరికే హీలియం ప్రభుత్వానిపిస్తోంది అని అనివార్యంగా తగ్గించుతోంది.	చైనా ఎలా అమెరికా నుండి సమకూర్చుకునే హీలియంపై తన ఆధారాన్ని తగ్గిస్తోంది?	చైనా యుఎస్ నుండి వచ్చే హీలియం మీద ఆధారపడటాన్ని తగ్గిస్తున్నది.
Kindle Colorsoft owners complain of a yellow bar on the e-reader’s screen	కిండల్ కలర్సాఫ్ట్ యజమానులు ఈ-రీడర్ స్క్రీన్లో పిల్ల బార్ గురించి ఫిక్షన్ చేస్తున్నారు.	కిండిల్ కలర్‌సాఫ్ట్ యజమానులు ఈ-రీడర్ స్క్రీన్‌పై పసుపు గీత కనిపిస్తుందని ఫిర్యాదు చేస్తున్నారు.	కిండిల్ కలర్సాఫ్ట్ యజమానులు ఈ-రీడర్ స్క్రీన్లో పసుపు బార్ గురించి ఫిర్యాదు చేస్తున్నారు.
Nvidia and its partners built a sophisticated system to bypass U.S. restrictions on exporting AI chips to the Middle East, Russia, and China.	Nvidia మరియు అది భాగస్వాములు మధ్య పూర్వానాలకు, రష్యా, చైనా పోటీలకు AI చిప్స్ ని ఎక్స్పోర్ట్ చేయడానికి U.S. పరిబంధములను నిమిత్తం ఒక సాధారణ వ్యవస్థ ని నిర్మించారు.	Nvidia మరియు వారి భాగస్వాములు మిడిల్ ఈస్ట్, రష్యా, చైనా దేశాలకు AI చిప్‌లను ఎగుమతి చేసే అమెరికా పరిమితులను అధిగమించడానికి ఒక అధునాతన వ్యవస్థను నిర్మించారు.	న్విడియా మరియు వారి భాగస్వాములు యు.ఎస్. పరిమితులను తప్పించడానికి మధ్య ప్రాచ్యం, రష్యా, చైనాలకు ఎఐ చిప్స్ ఎగుమతి చేయడానికి ఒక సోఫిస్టికేటెడ్ వ్యవస్థను నిర్మించారు.
The funding, which will top up the firm’s flagship fund, will be raised primarily from institutional investors. 	ఆ నిధులు, జరుగుటకు ప్రధానంగా సంస్థాగత వినియోగదారుల నుండి సంపాదించబోతున్న ఫర్మ్ యొక్క ముఖ్య నిధికి జోడించబోతుంది.	సంస్థ యొక్క ప్రధాన నిధిని పెంచడానికి ఈ నిధులు సంస్థాగత పెట్టుబడిదారుల నుండి ప్రధానంగా సేకరించబడతాయి.	ఆ సంస్థ యొక్క ప్రధాన నిధిని పూరించే ఆర్థిక సహాయం ప్రధానంగా సంస్థాగత పెట్టుబడిదారుల నుండి సేకరించబడుతుంది.
US Forest Service Decision to Halt Prescribed Burns in California is History Repeating	క్యాలిఫోర్నియాలో ప్రెస్క్రైబ్డ్ బర్న్స్ నిలిపివేయడానికి యుఎస్ వన సేవల సరఫరా ప్రాచీన చరిత్ర పునరావృత్తి అంటే.	అమెరికా అడవుల విభాగం కాలిఫోర్నియాలో ప్రిస్క్రైబ్డ్ బర్న్స్ ని ఆపడానికి తీసుకున్న నిర్ణయం చరిత్రను పునరావృతం చేస్తోంది.	అమెరికా అటవీ సేవా సంస్థలు కాలిఫోర్నియాలో నిర్దేశిత అగ్ని ప్రయోగాలను ఆపివేసే నిర్ణయం చరిత్ర పునరావృతం అవుతుంది.
The man who gave us the solution to the Entscheidungsproblem	ది మ్యాన్ హు గేవే అస్ ద సొల్యూషన్ టు ది ఎంట్సైడుంగ్స్ప్రొబ్లెమ్.	ఎంత్షైడుంగ్స్‌ప్రొబ్లెమ్‌కు పరిష్కారం ఇచ్చిన మనిషి.	వ్యక్తులు మనకు ఎంట్స్చైడుంగ్స్‌ప్రోబ్లెం పరిష్కారం ఇచ్చినవారు.
The shift in policy, covering government agencies and contractors working on national security, is intended to promote “responsible and ethical” innovations, the company said.	పొలిసులు, మంత్రులు మరియు ఇతర అధికారులు మీద ముఖ్యమైన కార్యవస్తులు పనిచేస్తున్న ప్రభుత్వ సంస్థలకు అదేపై మార్పులు అనుకూలంగా “జవాబ్దారిక మరియు నైతిక” ప్రయోజనాలను ప్రోత్సాహించేందుకు ఆ కంపెనీ చెబుతుంది.	"పాలసీ మార్పు, జాతీయ భద్రతపై పనిచేసే ప్రభుత్వ సంస్థలు మరియు కాంట్రాక్టర్లను కవర్ చేస్తూ, ""బాధ్యతాయుతమైన మరియు నైతిక"" ఆవిష్కరణలను ప్రోత్సహించడానికి ఉద్దేశించబడిందని ఆ కంపెనీ చెప్పారు."	"ప్రభుత్వ సంస్థలు మరియు జాతీయ భద్రత పనుల్లో పనిచేసే కాంట్రాక్టర్లను కవర్ చేసే విధాన మార్పు, ఆ సంస్థలు ""నైతిక మరియు బాధ్యతాయుతమైన"" నూతన ఆవిష్కరణలను ప్రోత్సహించడానికి ఉద్దేశించబడింది, ఆ కంపెనీ చెప్పింది."
China reveals a new heavy lift rocket that is a clone of SpaceX’s Starship	చైనా ఒక క్లోన్ అయిన SpaceX స్టార్‌షిప్ కోసం చిన్న భారీ లిఫ్ట్ రాకెట్ యొక్క తెలిపింది.	చైనా వారి కొత్త హెవీ లిఫ్ట్ రాకెట్‌ను ఆవిష్కరించారు, ఇది స్పేస్‌ఎక్స్ వారి స్టార్‌షిప్‌కు క్లోన్‌గా ఉంది.	చైనా అధికారులు స్పేస్ ఎక్స్ యొక్క స్టార్ షిప్ ను ప్రతిరూపంగా ఉన్న ఒక కొత్త భారీ ఎత్తు రాకెట్ ను వెల్లడించారు.
Singapore requires vehicle owners to bid for a set number of Certificates of Entitlement – costly operating permits valid for only ten years.	సింగపూర్ వాహన యజమానులకు కేసులు అందుబాటు చేయడానికి ఒక నిర్ధారిత సంఖ్యను కోరబడుతుంది - కేవలం పది ఏళ్లనే చరిత్రలకు మాత్రమే వాలీడ్ అయిన మంజూరుల కోసం మీరు బిడ్ చేయాలి.	సింగపూర్‌లో వాహన యజమానులు నిర్దిష్ట సంఖ్యలో ఎంటైటిల్‌మెంట్ సర్టిఫికేట్‌ల కోసం బిడ్ చేయాలని కోరుతున్నారు – ఇవి కేవలం పది సంవత్సరాలపాటు మాత్రమే చెల్లుబాటు అయ్యే ఖరీదైన ఆపరేటింగ్ అనుమతులు.	సింగపూర్ అధికారులు వాహన యజమానులకు పది సంవత్సరాల పాటు విలువైన నిర్వహణ పర్వేక్షణ పత్రాలను కొనుగోలు చేయడానికి ఆదేశిస్తున్నారు.
The Hwasong-19 is North Korea’s biggest missile yet and its test comes during a time of notable tensions on the peninsula.	హ్వాసాంగ్-19 ఉత్తర కొరియా యొక్క అత్యంత పెద్ద మిసైల్ మరియు అది ప్రాంతంలో మెరిసిన తాకుల సమయంలో వచ్చే పరీక్ష అయితుంది.	హ్వాసోంగ్-19 ఉత్తర కొరియా యొక్క ఇప్పటివరకు ఉన్న అతిపెద్ద క్షిపణి మరియు దీని పరీక్ష ద్వీపకల్పంలో విశిష్టమైన ఉద్రిక్తతల సమయంలో జరుగుతోంది.	హ్వాసాంగ్-19 ఉత్తర కొరియా యొక్క అతిపెద్ద క్షిపణి మరియు దాని పరీక్ష ద్వీపకల్పంలో గణనీయమైన ఉద్రిక్తతల సమయంలో జరుగుతుంది.
The species may have been carried to the Sacramento–San Joaquin Delta in ballast water on ships	జనాధిపతులకు (authorities) ముఖ్యంగా కప్పిగా ఉండవచ్చునని (may have been) విధులలో (species) Sacramento-San Joaquin డెల్టాకు పరిమాణంలో (ballast water) వచ్చిన పోరాటంలో (ships) వద్ద ప్రయాణించబడింది.	ఆ ప్రజాతి నౌకల సమతుల్య జలంలో సాక్రమెంటో-సాన్ జోక్విన్ డెల్టాకు తీసుకురాబడి ఉండవచ్చు.	జాతులు ఆనవాలు నీటిలో ఓడలపై సాక్రమెంటో-సాన్ జోక్విన్ డెల్టాకు తీసుకువెళ్ళి ఉండవచ్చు.
Discovery partnered with PR firm Relevance International to produce ultra-luxury experiences and products under the banner of fictionaire billionaire Bruce Wayne’s conglomerate.	డిస్కవరీ మరియు పిఆర్ ఫర్మ్ రిలెవన్స్ ఇంటర్నేషనల్ తో చిత్రించబడుతున్న అత్యధిక లక్ష్యాల మరియు ఉత్పాదనలను నిర్మించడానికి ఫిక్షనెయర్ బిలియన్ బ్రూస్ వెయిన్ యొక్క కాంగ్లొమరేట్ కి అడుగుల ప్రతీకం పట్టిక కి ఒప్పందానికి పార్ట్నర్ అయింది.	డిస్కవరీ వారు పి.ఆర్. సంస్థ రెలెవెన్స్ ఇంటర్నేషనల్ తో కలిసి ఫిక్షనైర్ బిలియనీర్ బ్రూస్ వెయిన్ వారి సమూహం కింద అల్ట్రా-లగ్జరీ అనుభవాలు మరియు ఉత్పత్తులను ఉత్పత్తి చేసేందుకు భాగస్వామ్యం చేసుకున్నారు.	డిస్కవరీ ప్రతిష్టాత్మక సంస్థలు రిలేవన్స్ ఇంటర్నేషనల్ అనే పీఆర్ సంస్థలతో కలిసి అత్యుత్తమ లక్షురీ అనుభవాలు, ఉత్పత్తులను ఫిక్షనైర్ బిలియనీర్ బ్రూస్ వేన్ యొక్క సంఘటనలో ఉత్పత్తి చేస్తున్నాయి.
Water utilities and chemical manufacturers are challenging the new EPA standards. 	నీరు యూటిలిటీస్ మరియు రసాయన నిర్మాతలు కొత్త EPA మానాయాలను ప్రతిష్టాత్మకంగా సాధించుకున్నారు.	నీటి సేవలు మరియు రసాయన తయారీదారులు కొత్త EPA ప్రమాణాలను సవాలు చేస్తున్నారు.	నీటి సదుపాయాలు మరియు రసాయన తయారీదారులు కొత్త ఇపిఎ ప్రమాణాలను సవాలు చేస్తున్నారు.
A radio station in Poland fired its on-air talent and brought in A.I.-generated presenters. An outcry over a purported chat with a Nobel laureate quickly ended that experiment.	పోలండ్‌లో ఒక రేడియో స్టేషన్ తన ప్రసార సామర్థ్యంను ఫైర్ చేశారు మరియు ఐ.ఐ.-తయారు ప్రస్తుతాలను అమలుకు తీసింది. నోబెల్ విజేతలుతో సంభాషణ గురించి ఒక అనుమానంతో ప్రకారం ఉత్పాదనను ప్రత్యర్థించాలి.	పోలాండ్‌లోని ఒక రేడియో స్టేషన్ తమ ఆన్-ఎయిర్ ప్రతిభను తొలగించి, A.I. సృష్టించిన వ్యాఖ్యాతలను తీసుకువచ్చింది. ఒక నోబెల్ బహుమతి గ్రహీతతో జరిగినట్లు భావించిన సంభాషణపై వచ్చిన నిరసనతో ఆ ప్రయోగం త్వరగా ముగిసింది.	పోలాండ్ లోని ఒక రేడియో స్టేషన్ తన ఆన్-ఎయిర్ ప్రతిభావంతులను తొలగించి, ఎయిఐ-జనరేటెడ్ ప్రజెంటర్లను తీసుకువచ్చింది. ఒక నోబెల్ లారియేట్ తో జరిగిన పురాతన చర్చ ఆ ప్రయోగాన్ని త్వరగా ముగించింది.
From infancy, children show heightened interest in events that are impossible or improbable, relative to likely events.	పుట్టినింటికి, పిల్లలు సాధ్యం లేదా అసాధ్యం కాదు, కాని సాధ్యం ప్రస్తుతం చూస్తున్నారు.	శిశువయస్సు నుండే, పిల్లలు సాధ్యమో లేదో లేదా అసంభవమైన సంఘటనల పట్ల ఎక్కువ ఆసక్తిని చూపిస్తారు, సాధ్యమైన సంఘటనలతో పోలిస్తే.	శిశువుల నుండి, వారు అసంభవమైన లేదా అప్రత్యక్ష ఘటనలపై సాధారణ ఘటనల కంటే ఎక్కువ ఆసక్తిని ప్రదర్శిస్తారు.
Four persons were referred to hospital and the rest were treated as outpatients at the event venue, police sources said.	పోలీసుల మూలం నాలుగు వ్యక్తులు ఆస్పత్రికి నిర్దేశించబడినవి మరియు మిగిలి వ్యక్తులను ఇవేంట్ స్థలంలో ఔట్‌పేషెంట్స్‌గా చికిత్స చేసాం, పోలీసుల సోర్సులు చెప్పారు.	నాలుగు వ్యక్తులను ఆసుపత్రికి పంపించారు మరియు మిగతా వారికి ఈవెంట్ ప్రదేశంలోనే అవుట్‌పేషెంట్‌గా చికిత్స అందించారు, పోలీసు వర్గాలు తెలిపారు.	నలుగురు వ్యక్తులు ఆస్పత్రికి పంపబడ్డారు, మిగిలిన వారు ఈవెంట్ వేదికపై ఔట్ పేషెంట్లుగా చికిత్స పొందారు, పోలీసు సోర్సులు చెప్పారు.
During investigation, the Washermenpet police found that he was attacked by three persons with stones and beer bottles while he was consuming alcohol.	చర్చలో, వాషర్మెన్పేట్ పోలీసులు అది ఆల్కహల్ వినముగా ఉన్నప్పుడు మూడు వ్యక్తులు పత్థరాలు మరియు బీరు బాటల్లుతో ఆక్రమించారని కనుగొన్నారు.	పరిశోధన సమయంలో వాషర్‌మెన్‌పేట పోలీసులు ఆయనపై ముగ్గురు వ్యక్తులు రాళ్ళు మరియు బీర్ బాటిళ్లతో దాడి చేసినట్లు గుర్తించారు, ఆయన మద్యం సేవిస్తున్నప్పుడు.	విచారణలో, వాషర్మెన్‌పేట పోలీసులు ఆయన మూడు వ్యక్తులచే రాళ్లు, బీరు సీసాలతో దాడి చేయబడినట్లు, ఆయన మద్యం సేవిస్తున్న సమయంలో కనుగొన్నారు.
Two juvenile boys who were lodged at the Government Observation Home in Chengalpattu escaped on Tuesday night.	రేపు రాత్రి చెంగల్పట్టులో సర్కారు నివాస ఇంటిలో ఉన్న రెండు వయోజన వారు ఎప్పుడైనా భాగంగా నడిపారు.	చెంగల్పట్టు లోని ప్రభుత్వ పరిశీలనా గృహంలో ఉన్న ఇద్దరు బాలురు మంగళవారం రాత్రి పారిపోయారు.	చెంగల్పట్టులోని ప్రభుత్వ పరిశీలన ఇల్లులో ఉన్న ఇద్దరు కిషోరులు మంగళవారం రాత్రి తప్పించుకున్నారు.
During Mr. Gandhi’s Srinagar stay, men disembarked from cars on Boulevard road to hug him.	గాంధీ శ్రీనగర్ ప్రవాసంలో, అల్లరు రోడ్‌లో తనను గౌరవించడానికి కారుల నుండి వచ్చిపోయారు.	గాంధీ గారి శ్రీనగర్ వసతి సమయంలో, బౌలెవార్డ్ రోడ్డుపై కార్ల నుండి దిగి వచ్చిన వ్యక్తులు ఆయనను ఆలింగనం చేసుకున్నారు.	శ్రీ గాంధీ గారు శ్రీనగర్ లో ఉన్న సమయంలో, వారు బులేవార్డ్ రోడ్ పై కార్ల నుండి దిగి వారిని కౌగలించుకున్నారు.
They alleged that several brick kilns started selling old stocks of bricks from Wednesday after paying the first instalment of the fine levied on them by the Geology and Mining Department.	వారు పదినాలు మరియు ఖనిజశాస్త్ర విభాగం ద్వారా వర్షగా విధించిన జరిమానా కి మొదటి పెట్టిన తరువాత కిల్నుల నుండి పానీయం రూపంలో పురాణపు స్టాక్స్ ను విక్రయించడం ప్రారంభించారని తెలిపారు.	వీరు ఆరోపించారు, బుధవారం నుండి జియాలజీ మరియు మైనింగ్ శాఖ వారు విధించిన జరిమానా యొక్క మొదటి విడత చెల్లించిన తర్వాత అనేక ఇటుక బట్టీలు పాత నిల్వల ఇటుకలను అమ్మడం ప్రారంభించాయని.	వారు ఆరోపించారు కి బుధవారం నుండి వారిపై భూగర్భ శాస్త్ర మరియు గని శాఖ విధించిన జరిమానా మొదటి విడత చెల్లించిన తరువాత అనేక ఇటుక కిల్నులు పాత స్టాకులను అమ్మడం ప్రారంభించాయి.
Ten Indian career diplomats, who are High Commissioners or Ambassadors of India in other countries, called on Governor R.N. Ravi at the Raj Bhavan in Chennai on Monday.	భారతీయ కెరీర్ డిప్లొమెట్స్ దశ దేశాలలో హై కమిషనర్లు లేదా భారత రాష్ట్రాధిపతి ఆర్.ఎన్. రవిని చెన్నైలో రాజ్ భవన్‌లో మంగళవారం కల్లిని.	భారతదేశానికి ఇతర దేశాలలో ఉన్న హై కమిషనర్లు లేదా అంబాసిడర్లు అయిన పది మంది భారత కేరియర్ డిప్లొమాట్స్, సోమవారం చెన్నైలోని రాజ్ భవన్‌లో గవర్నర్ ఆర్.ఎన్. రవిని కలిసారు.	భారత దేశానికి ఇతర దేశాలలో హై కమీషనర్లు లేదా అంబాసిడర్లుగా ఉన్న పది మంది భారతీయ కెరీర్ డిప్లోమాట్స్ గవర్నర్ ఆర్.ఎన్. రవి గారిని సోమవారం చెన్నైలోని రాజ్ భవన్ లో కలుసుకున్నారు.
However, Dr. Hande, who wrote the foreword for her book and took part in some of these Assembly debates, says Muthu discharged her duty efficiently as a Minister with no room for corruption.	కానీ, ఆమె పుస్తకంకు అంతర్వ్యాఖ్యానం రాయడం మరియు ఈ పార్లమెంటు చర్చలలో కొంత విధానాల్లో పాల్గొన్నవాడు డాక్టర్ హందే. హాదా మంత్రిగా తన కర్తవ్యాన్ని కార్యకరంగా చేయడం తప్పక కొద్ది స్థానం ఉండకపోయిందని మిత్రుడు ముత్తు చెప్పాడు.	అయితే, డా. హాండే గారు, ఆమె పుస్తకానికి ముందుమాట రాసిన వారు మరియు ఈ అసెంబ్లీ చర్చల్లో కొన్ని పాల్గొన్న వారు, ముత్తు ఆమె బాధ్యతను ఒక మంత్రిగా అవినీతి లేని విధంగా సమర్థవంతంగా నిర్వర్తించారని అంటున్నారు.	అయితే, ఆమె పుస్తకం ముందుమాట రాసిన డాక్టర్ హండే, ఆ అసెంబ్లీ చర్చల్లో కొన్నింటిలో పాల్గొన్నారు, మంత్రులు ముత్తు తమ విధుల్ని సమర్థవంతంగా నిర్వహించారు, అవినీతికి ఎటువంటి స్థలం లేదు.
While both Mr. Lobo and Mr. Kamat have cited disaffection with the Congress high command as reasons, the true reasons are all too transparent.	శ్రీమంతులారా లోబో మరియు శ్రీమంతులారా కామట్ రెండూ కాంగ్రెస్ హై కమాండ్ నుండి విరాగమును కారణాలను సూచించారు, కాని నిజానికి కారణాలు ఎలాంటి పరిపూర్ణత కనిపిస్తున్నాయి.	శ్రీలోబో మరియు శ్రీకామత్ ఇద్దరూ కాంగ్రెస్ ఉన్నతాధికారులతో అసంతృప్తిని కారణంగా పేర్కొన్నప్పటికీ, వాస్తవ కారణాలు చాలా స్పష్టంగా ఉన్నాయి.	లోబో గారు, కామట్ గారు ఇద్దరూ కాంగ్రెస్ హైకమాండ్ తో అసంతృప్తిని కారణాలుగా చెప్పినప్పటికీ, నిజమైన కారణాలు అన్ని స్పష్టంగా ఉన్నాయి.
The first festival celebrating the linguistic and cultural ties between the Barak Valley region of Assam and the Sylhet segment of Bangladesh began on Friday evening.	ఆసాం బారక్ వ్యాలీ ప్రాంతంతో బంగ్లాదేశ్ సిల్హేట్ విభాగం లలితాంశాల మరియు సాంస్కృతిక సంబంధాలను జయించే ప్రథమ సందర్భంగా జముకోయి రాత్రి ప్రారంభమయ్యింది.	ఆసాం రాష్ట్రంలోని బరాక్ వ్యాలీ ప్రాంతం మరియు బంగ్లాదేశ్‌లోని సిల్హెట్ భాగం మధ్య భాషా మరియు సాంస్కృతిక సంబంధాలను జరుపుకునే మొట్టమొదటి పండుగ శుక్రవారం సాయంత్రం ప్రారంభమైంది.	ఆసాం లోని బారక్ వ్యాలీ ప్రాంతం మరియు బంగ్లాదేశ్ లోని సిల్హెట్ విభాగం మధ్య భాషా సాంస్కృతిక బంధాలను సంతోషంగా జరుపుకునే మొదటి ఉత్సవం శుక్రవారం సాయంత్రం ప్రారంభమైంది.
The objective of such markets is to incentivise investments in renewable energy sources.	ఇంతకానీ మార్కెట్ల లక్ష్యం పునరుత్థాన శక్తుల నివేశాలకు ప్రోత్సాహం ఇస్తుంది.	అటువంటి మార్కెట్ల లక్ష్యం పునరుత్పాదక శక్తి వనరులపై పెట్టుబడులను ప్రోత్సహించడమే.	ఆ మార్కెట్ల లక్ష్యం పునరుత్పాదక శక్తి వనరుల్లో పెట్టుబడులను ప్రోత్సహించడం.
The Centre is expected to clarify, later this year, the specifics of a carbon trading market in India.	భారతదేశంలో కార్బన్ ట్రేడింగ్ మార్కెట్ యొక్క వివరాలను ఈ సంవత్సరం అంతకు తరువాయి, కేంద్రం వ్యాఖ్యానించడం అంటున్నారు.	కేంద్రం ఈ సంవత్సరం తర్వాత భారతదేశంలో కార్బన్ ట్రేడింగ్ మార్కెట్ యొక్క వివరణలను స్పష్టతనిచ్చే అవకాశముంది.	కేంద్రాలు ఈ సంవత్సరం చివరిలో భారతదేశంలో కార్బన్ ట్రేడింగ్ మార్కెట్ యొక్క వివరాలను స్పష్టం చేయబోతున్నాయి.
Hydrogen is an essential industrial fuel that has a range of uses from producing ammonia.	హైడ్రజన్ ఒక అవసరమైన ఔద్యోగిక ఈతనం మరియు అమ్మోనియా తయారు చేయడానికి వివిధ ఉపయోగాల వరకు ఉండే ఒక ముఖ్య ఈతనంగా ఉంది.	హైడ్రోజన్ అనేది ఒక ముఖ్యమైన పారిశ్రామిక ఇంధనం, ఇది అమోనియా ఉత్పత్తి నుండి వివిధ ఉపయోగాల వరకు విస్తరించినది.	హైడ్రోజన్ ఒక అవసరమైన పారిశ్రామిక ఇంధనం యేది అమ్మోనియా ఉత్పత్తి చేయుటకు వివిధ ఉపయోగాలను కలిగి ఉంది.
Finance Minister Nirmala Sitharaman on Saturday said that regulators would do their job.	ఆదివారం ఆర్థిక మంత్రి నిర్మల సీతారామన్ అంటూ అంగీకారించబడినది నియంత్రకులు తమ కృత్యం చేస్తారని.	శనివారం నాడు ఆర్థిక శాఖా మంత్రి నిర్మలా సీతారామన్ గారు నియంత్రణాధికారులు తమ విధులను నిర్వహిస్తారని తెలిపారు.	ఆర్థిక మంత్రులు నిర్మలా సీతారామన్ శనివారం చెప్పారు కి రెగ్యులేటర్లు వారి పని చేస్తారు.
Madras has received a grant of ₹242 crore to do research on laboratory-grown diamonds.	మద్రాసులో ప్రయోగశాల తోటి వాడిన హిరాల పరిశోధన కోసం ₹242 కోట్ల అనుదానం పొందింది.	మద్రాస్‌కు ప్రయోగశాలలో పెంచిన వజ్రాలపై పరిశోధన చేయడానికి ₹242 కోట్ల మంజూరు అందింది.	మద్రాస్ వారు ₹242 కోట్ల గ్రాంట్ ను లాబొరేటరీ-పెంచిన వజ్రాల పరిశోధనకు పొందారు.
Before Rao took leave after the meeting, MGR gently reminded him of the Cauvery water.	సభ నిరవచించిన తరువాతు, ఎమ్జీఆర్ రావునికి కావేరి నీరు గురించి స్నేహముగా అనుగ్రహంగా జెండారా చెప్పాడు.	రావు గారు సమావేశం తరువాత సెలవు తీసుకోవడానికి ముందుగా, ఎంజీఆర్ గారు వారికి కావేరీ నీటి గురించి సున్నితంగా గుర్తుచేశారు.	రావు సమావేశం తర్వాత సెలవు తీసుకునే ముందు, మీ గౌరవాలు కావేరి నీటి గురించి మీరు అతనికి మెల్లగా గుర్తు చేశారు.
It is because of this initiative that Tamil Nadu became the centre of higher learning.	ఇది కారణం ఉచ్చ విద్య కేంద్రంగా తమిళనాడు అయింది.	ఈ కార్యక్రమం వల్లే తమిళనాడు ఉన్నత విద్యాకేంద్రంగా మారింది.	ఈ ఉద్యమం వల్ల తమిళనాడు ఉన్నత విద్యా కేంద్రంగా అయింది.
However, within minutes after the then Prime Minister intervened.	ఇది కాని నిమిషాలు నియంత్రించిన తరువాత పూర్వ ప్రధాని పలువురి సహాయం తో.	అయితే, అప్పటి ప్రధాన మంత్రి జోక్యం చేసుకున్న కొద్దిసేపట్లో.	అయితే, అప్పటి ప్రధాన మంత్రులు వారు పరిపాలించిన కొద్ది నిమిషాల్లోనే.
The initial shock following the Taliban’s seizure of power in Kabul is waning.	కాబుల్‌లో టాలిబాన్ శక్తి తీసుకొన్న తరువాత ప్రారంభ షాక్ తగ్గుతోంది.	కాబూల్‌లో తాలిబాన్ అధికారాన్ని స్వాధీనం చేసుకున్న తరవాత వచ్చిన ప్రారంభ దెబ్బ తగ్గిపోతోంది.	కాబుల్లో తాలిబాన్ల అధికారం స్వీకరణ తరువాత మొదటి ఆఘాతం తగ్గిపోతోంది.
The greatest impact of denial of rights for women in the workforce would be a sharp contraction in the economy.	స్త్రీలకు హక్కుల తప్పులో అనుమానించిన పరిణామం వ్యవసాయంలో తీవ్ర క్రమేణ మందులు ఉండతాయి.	కార్యక్షేత్రంలో మహిళల హక్కుల నిరాకరణ వల్ల కలిగే అత్యంత ప్రభావం ఆర్థిక వ్యవస్థలో తీవ్రమైన సంకోచం కావచ్చు.	స్త్రీలకు ఉద్యోగ రంగంలో హక్కుల నిరాకరణ యొక్క అత్యధిక ప్రభావం ఆర్థిక వ్యవస్థలో తీవ్రమైన సంకోచం అవుతుంది.
The Taliban do not shy from leveraging the issue to gain international attention.	టాలిబాన్ అంతర్జాతీయ గమ్యాన్ని పొందడానికి విషయాన్ని ఉపయోగించడం నుండి తిమిరము కాదు.	తాలిబాన్ అంతర్జాతీయ దృష్టిని ఆకర్షించడానికి ఈ సమస్యను ఉపయోగించడంలో వెనుకడుగు వేయరు.	తాలిబాన్ వారు అంతర్జాతీయ శ్రద్ధను పొందడానికి ఈ సమస్యను ఉపయోగించుకోవడానికి సంకోచించరు.
In Jammu and Kashmir, the enrolment dropped sharply from 1.78 lakh in 2019-20 to 1.31 lakh in 2020-21.	జమ్ము మరియు కాశ్మీర్లో, 2019-20 లో 1.78 లక్షల నుండి 2020-21 లో 1.31 లక్షలకు నమోదు తగినది.	జమ్మూ మరియు కాశ్మీర్‌లో, 2019-20లో 1.78 లక్షలుగా ఉన్న నమోదు 2020-21లో 1.31 లక్షలకు గణనీయంగా తగ్గింది.	జమ్ము కాశ్మీర్ లో, వారు 2019-20 లో 1.78 లక్షలకు నుండి 2020-21 లో 1.31 లక్షలకు నమోదు తీవ్రంగా తగ్గింది.
Senior advocate Meenakshi Arora made the oral mentioning for early hearing.	ప్రముఖ ఆడ్వొకేట్ మీనాక్షి అరోరా త్వరలో విచారణ కోసం వాక్యాన్ని చేసినారు.	జ్యేష్ఠ న్యాయవాది మీనాక్షి అరోరా గారు త్వరితగతిన విచారణ జరపాలని నోటిమాటల ద్వారా ప్రస్తావించారు.	సీనియర్ అడ్వొకేట్లు మీనాక్షి ఆరోరా వారు ఆరంభ విన్నపం కోసం మౌఖిక ప్రస్తావన చేశారు.
The State had never forced students out of State schools by restricting hijab.	రాష్ట్రం హిజాబ్ పరిమితం చేసి విద్యార్థులను రాష్ట్ర పాఠశాలలో నుండి బహిష్కరించలేదు.	రాష్ట్రం హిజాబ్ పరిమితం చేయడం ద్వారా విద్యార్థులను రాష్ట్ర పాఠశాలల నుండి బలవంతంగా బయటకు పంపలేదు.	రాష్ట్రాలు ఎప్పుడూ హిజాబ్ పరిమితులను ఆంశికంగా రాష్ట్ర పాఠశాలల నుండి విద్యార్థులను బహిష్కరించలేదు.
The patient has the right to refuse to participate in such research projects.	రోగికి అంతర్జాల ప్రాజెక్టులలో పాల్గొనడం అధికారం ఉంది.	ఆరోగ్యం పొందుతున్నవారు అలాంటి పరిశోధన ప్రాజెక్టులలో పాల్గొనడానికి నిరాకరించే హక్కును కలిగి ఉంటారు.	రోగులు ఆ ప్రాజెక్టుల్లో పాల్గొనడానికి నిరాకరించే హక్కు కలిగి ఉన్నారు.
The field officials should remember it while implementing projects. 	పదిహేనుల అధికారులు పద్దతులు కార్యకలాపాలు అమలు చేస్తూ ఇదన్ను గుర్తుంచేందుకు గమనించాలి.	ప్రాజెక్టులు అమలు చేస్తూ ఉన్నప్పుడు, మీరు, ఫీల్డ్ అధికారులు, దానిని గుర్తుంచుకోవాలి.	ప్రాంతీయ అధికారులు ప్రాజెక్టులను అమలు చేసేటప్పుడు దీన్ని గుర్తుంచుకోవాలి.
Senior officials in the Ministry of Tribal Affairs said a change in the structure had already been approved.	జనాదిపతులు ప్రజాసంబంధ శాఖలో ప్రధాన అధికారులు మార్గంలో ఒక మార్పు అనుమోదించబడిందని ప్రకటించారు.	గిరిజన వ్యవహారాల మంత్రిత్వ శాఖలో సీనియర్ అధికారులు చెప్పారు, నిర్మాణంలో మార్పు ఇప్పటికే ఆమోదించబడిందని.	మీ గిరిజన వ్యవహారాల మంత్రిత్వ శాఖలోని ఉన్నతాధికారులు ఒక సంస్థానిక మార్పును ఇప్పటికే ఆమోదించారు.
The Bhagwan Mahaveer Foundation has called for applications for the Mahaveer awards.	భగవాన్ మహావీర్ ఫౌండేషను మహావీర్ పురస్కారాలకు అప్లికేషన్లను అభ్యర్థన కోసం పెట్టింది.	భగవాన్ మహావీర్ ఫౌండేషన్ మహావీర్ అవార్డుల కోసం దరఖాస్తులను ఆహ్వానిస్తున్నారు.	భగవాన్ మహావీర్ ఫౌండేషన్ వారు మహావీర్ అవార్డులకు దరఖాస్తులను ఆహ్వానించారు.
Mr. Yediyurappa resigned as Chief Minister and was succeeded by Basavaraj Bommai in 2020.	శ్రీ యేదియూరప్ప ముఖ్యమంత్రిగా రాజీనామా చేసి, 2020లో బసవరాజ్ బొమ్మయ్ విజయవంతంగా ప్రతిష్ఠా చేసాడు.	యేడియూరప్ప గారు ముఖ్యమంత్రిగా రాజీనామా చేసి, 2020లో ఆయన స్థానాన్ని బసవరాజ్ బొమ్మాయి గారు భర్తీ చేశారు.	శ్రీ యేడియూరప్పగారు ముఖ్యమంత్రులుగా రాజీనామా చేసి, 2020లో బసవరాజ్ బొమ్మైగారు వారి స్థానంలో వచ్చారు.
The rescuers had to cut the roof of the lift to bring them out, and nobody was hurt.	రక్షకులు వాల్టు మీద ఛాయలు కోపించడానికి అవిని బయటకు తీయాలని వచ్చారు, మరియు ఎవరూ గాయం కలిగలేదు.	రక్షకులు వారిని బయటకు తీసుకురావడానికి లిఫ్ట్ పైకప్పును కత్తిరించవలసి వచ్చింది, మరియు ఎవరూ గాయపడలేదు.	రక్షకులు వారిని బయటకు తీసుకురావడానికి ఎలివేటర్ పైకప్పు కోసి వేశారు, ఎవరూ గాయపడలేదు.
The group claimed another police station attack in Rask that killed one officer on January 10.	గుండు నకారాత్మక ఆక్రమణం ఘోరం అయినప్పుడు జనాభా జనాభానికి విలంబించిన రాస్క్ లో జనవారి 10 న ఒక పోలీసు అధికారిని చాటించింది అని ప్రకటించారు.	రాస్క్‌లో జనవరి 10న ఒక అధికారిని చంపిన మరో పోలీస్ స్టేషన్ దాడిని ఆ గుంపు తమదిగా ప్రకటించారు.	ఆ సంస్థ రాస్క్ లో జనవరి 10 న ఒక అధికారిని చంపిన మరో పోలీస్ స్టేషన్ దాడిని ప్రకటించింది.
Based on the complaint, an FIR has been registered against Constable Shailendra Singh and three other policemen.	ప్రకరణం ఆధారితమైనది, కాన్స్టేబుల్ షైలేంద్ర్ సింగ్ మరియు మూడు ఇతర పోలీసుల వరకు FIR నమోదు చేయబడింది.	ఫిర్యాదు ఆధారంగా కానిస్టేబుల్ శైలేంద్ర సింగ్ మరియు ఇతర ముగ్గురు పోలీసులపై ఎఫ్‌ఐఆర్ నమోదు చేయబడినది.	ఫిర్యాదు ఆధారంగా, కానిస్టేబుల్ శైలేంద్ర సింగ్ మరియు ఇతర పోలీసుల మీద ఒక ఎఫ్ఐఆర్ నమోదు చేయబడింది.
Financial institutions also play a crucial role in tracking the money trails sustaining these networks.	ఆర్థిక సంస్థలు ఈ నెట్వర్కులను ఉంచుకునే డబ్బు కొలవానికి ముఖ్యమైన పాత్ర ప్రదర్శిస్తున్నాయి.	ఆర్థిక సంస్థలు ఈ నెట్‌వర్క్‌లను కొనసాగిస్తున్న డబ్బు మార్గాలను ట్రాక్ చేయడంలో కూడా కీలక పాత్ర పోషిస్తారు.	ఆర్థిక సంస్థలు కూడా ఈ నెట్వర్కులను సమర్థించే డబ్బు మార్గాలను ట్రాకింగ్ చేయడంలో కీలక పాత్ర పోషిస్తున్నాయి.
It is laudable that customs duties have been waived on three anti-cancer drugs.	మూడు వ్యాధి నివారించాల్సిన విరుధ్వాంకార ఔషధాల పేర్కొనుముదున చాటుపరికరాలు విరామించబడినది స్తుత్యముగా ఉంటుంది.	మూడు క్యాన్సర్‌ నిరోధక ఔషధాలపై సుంకాలను మాఫీ చేయడం ప్రశంసనీయమైన విషయం.	ఆయా అధికారులు మూడు కేన్సర్ వ్యాధి నివారణ మందులపై సరుకు సుంకాలను రద్దు చేసినందుకు అభినందనీయం.
Inside the final sprint in the biggest battleground state on the map.	మ్యాపులో అతి పెద్ద యుద్ధభూమిలో చివరి స్ప్రింట్లో ఉండేది.	పటంలో అతిపెద్ద పోరాట రంగంలో చివరిది స్ప్రింట్‌లో.	మ్యాప్‌లోని అతిపెద్ద యుద్ధరంగంలో చివరి స్ప్రింట్ లోపల.
All eyes are on America as an uncertain world awaits election result.	అమెరికా ప్రత్యక్షాలు ఎలాంటి కొత్తిగా ప్రపంచాన్ని కాదుకూడదు ఎంతో సందేహంగా ముందుకుంటున్నాయి.	అనిశ్చిత ప్రపంచం ఎన్నికల ఫలితాల కోసం వేచి ఉండగా, అన్ని కళ్లూ అమెరికాపై ఉన్నాయి.	అన్ని కళ్ళు అమెరికాపై ఉన్నాయి, అనిశ్చిత ప్రపంచం ఎన్నికల ఫలితాన్ని ఎదురుచున్నది.
Twitch faces criticism over Israel-Gaza war content on platform.	ప్లాట్ఫారంలో ఇస్రాయెల్-గాజా యుద్ధ కంటెంట్ పై ట్విచ్ క్రిటిసిజం చేస్తోంది.	Twitch ప్లాట్‌ఫారమ్‌పై ఇజ్రాయెల్-గాజా యుద్ధ కంటెంట్‌కు సంబంధించిన విమర్శలు ఎదుర్కొంటున్నారు.	ట్విచ్ వేదికపై ఇజ్రాయెల్-గాజా యుద్ధ సంబంధిత కంటెంట్ పై విమర్శలను ఎదుర్కొంటున్నది.
North Korea fires multiple ballistic missiles toward the sea ahead of U.S. election.	ఉత్తర కొరియా యు.ఎస్. ఎన్నికల ముందు సముద్రంకు ముల్టీపుల్ బాలిస్టిక్ మిసైలులు ప్రయోగించింది.	ఉత్తర కొరియా, అమెరికా ఎన్నికల ముందు సముద్రం వైపు అనేక బాలిస్టిక్ క్షిపణులను ప్రయోగించారు.	ఉత్తర కొరియా అధికారులు అమెరికా ఎన్నికల ముందు సముద్రం వైపు బహుళ బాలిస్టిక్ క్షిపణులను ప్రయోగించారు.
Singapore Airlines will add first class, revamp cabins for longest flights.	సింగపూర్ ఎయిర్లైన్స్ అత్యవసర వారానికి ఫస్ట్ క్లాస్ చేర్చడానికి, దీర్ఘమైన ప్రయాణాలకు క్యాబిన్లను రీవాంప్ చేస్తుంది.	సింగపూర్ ఎయిర్‌లైన్స్ వారు ఫస్ట్ క్లాస్‌ని జోడించి, అత్యంత పొడవైన ప్రయాణాల కోసం కేబిన్లను పునరుద్ధరించనున్నారు.	సింగపూర్ ఎయిర్లైన్స్ వారు ఫర్స్ట్ క్లాస్ ను జోడించి, అత్యంత పొడవైన ప్రయాణాల కొరకు కేబిన్లను పునర్వ్యవస్థీకరిస్తారు.
Priyanka Chopra Jonas and Nick Jonas celebrate 'Diwaloween,' Diwali and Halloween mashup.	ప్రియాంకా చోప్రా జోనస్ మరియు నిక్ జోనస్ 'దివాలోవీన్' జరుపుకున్నారు, దీపావళి మరియు హాలోవీన్ మిశ్రణం జరుపుకున్నారు.	ప్రియాంక చోప్రా జోనాస్ గార్లు మరియు నిక్ జోనాస్ గార్లు 'దివాలోవీన్,' దీపావళి మరియు హాలోవీన్ మిళితాన్ని జరుపుకుంటున్నారు.	ప్రియాంకా చోప్రా జోనాస్ మరియు నిక్ జోనాస్ వారు 'దీవాలోవీన్' ను జరుపుకుంటున్నారు, దీపావళి మరియు హాలోవీన్ మిశ్రమం.
Pennsylvania officials denounce Halloween float appearing to depict Harris tied to golf cart.	పెన్సిల్వేనియా అధికారులు గాల్ఫ్ కార్ట్కు కట్టుకునిపించినంతగా కనిపించే హ్యాలోవీన్ ఫ్లోట్ను ఖండనించారు.	పెన్సిల్వేనియా అధికారులు హాలోవీన్ ఫ్లోట్ హారిస్‌ను గోల్ఫ్ కార్ట్‌కు కట్టినట్లు చూపించడాన్ని ఖండించారు.	పెన్సిల్వేనియా అధికారులు హాలోవీన్ ఫ్లోట్ హారిస్ గోల్ఫ్ కార్ట్‌కు బంధించబడినట్లు కనిపిస్తున్నది ఖండిస్తున్నారు.
Elon Musk's election-doubting posts shared 9 times more than his less extreme election content.	ఎలాన్ మస్క్ నిర్వాహణ సందేహాన్ని ప్రకటించడానికి అంతా విలినమైన నిర్వాహణ కాంటెంట్ కంటే 9 సార్లు ఎక్కువగా భాగం చేసినప్పుడు షేర్ చేయబడింది.	ఎలాన్ మస్క్ గారి ఎన్నికలపై సందేహించే పోస్టులు ఆయన తక్కువ తీవ్రత కలిగిన ఎన్నికల కంటెంట్ కంటే 9 రెట్లు ఎక్కువగా పంచబడ్డాయి.	ఎలాన్ మస్క్ గారు ఎన్నికల సందేహాలు వ్యక్తం చేసిన పోస్టులు వారి తక్కువ ప్రతికూల ఎన్నిక సంబంధిత కంటెంట్ కన్నా 9 సార్లు ఎక్కువగా పంచుకున్నాయి.
Americans eye the economy from kitchen tables and hourly jobs as they plan their votes.	అమెరికన్లు తమ ఓటులను ప్రణాళిక చేస్తున్న వివిధ ఉద్యోగాల నుండి ఇంటి మంజి టేబుల్స్ ను చూస్తున్నారు.	అమెరికన్లు తమ ఓటు ప్రణాళికలు రూపొందించేటప్పుడు వంటగదుల టేబుళ్ల నుంచి మరియు గంటసమయ ఉద్యోగాల నుంచి ఆర్థిక వ్యవస్థను పరిశీలిస్తున్నారు.	అమెరికన్లు వారి ఓట్లను ప్లాన్ చేసేటప్పుడు వారు కిచెన్ టేబుల్స్ నుండి ఆర్థిక వ్యవస్థను చూస్తున్నారు, వారు తమ టైమ్ ఉద్యోగాలను నుండి చూస్తున్నారు.
Quincy Jones, musical maestro and entertainment industry titan, dies at 91.	క్విన్సీ జోన్స్, సంగీత మహామాహారత్నం మరియు వినోద పరిశ్రమ శాస్త్రవేత్త, 91 వయసులో మృతి పొందారు.	క్విన్సీ జోన్స్, సంగీత మేధావి మరియు వినోద పరిశ్రమ దిగ్గజులు, 91 ఏళ్ల వయసులో మరణించారు.	క్విన్సీ జోన్స్, సంగీత మహారాజులు మరియు వినోద పరిశ్రమ దిగ్గజాలు, 91 ఏళ్ళ వయస్సులో మరణించారు.
Proud Boys claim they'll be at polling places as Trump ups violent rhetoric and fraud claims	గర్వితమైన స్నేహితులు ట్రంప్ బలహీన భాషా మరియు పనేలు దానిని పెండించాలని దావతులు ముందుకు వస్తున్నారని కోసం ప్రతిపాదించారు.	గౌరవనీయులు, మీకు తెలియజేయదగినది ఏమనగా, ట్రంప్ గారు హింసాత్మక వ్యాఖ్యలు మరియు మోసం ఆరోపణలను పెంచుకుంటున్నప్పుడు, ప్రౌడ్ బాయ్స్ వారు పోలింగ్ కేంద్రాల్లో ఉంటామని వారు ప్రకటించారు.	ప్రౌడ్ బాయ్స్ వారు ట్రంప్ హింసాత్మక భాషణను పెంచుతున్నప్పుడు, వారు ఓటింగ్ స్థలాలలో ఉంటారని చెబుతున్నారు.
One of the police officers stumbled to the ground when the driver applied brakes and attempted to strike him.	పోలీసులు ఒకరు డ్రైవరు బ్రేకులను వాడితే భూమికి పడ్డారు మరియు అవని ఆక్రమించడానికి ప్రయత్నించాడు.	ఒకరు డ్రైవర్ బ్రేకులు వేస్తూ అతనిని ఢీకొట్టేందుకు ప్రయత్నించినప్పుడు, పోలీసు అధికారులలో ఒకరు నేలపై కూలిపోయారు.	ఒక పోలీస్ అధికారులు డ్రైవర్ బ్రేక్స్ అప్లై చేసి వారిని కొట్టడానికి ప్రయత్నించినప్పుడు నేల క్రింద పడిపోయారు.
The authorities confirmed they have identified the vehicle's owner and expect to make an arrest shortly.	అధికారులు వాహనం యజమానిని గుర్తించారు మరియు తక్కువ సమయంలో అరెస్టు చేయడానికి ఆశిస్తున్నారు.	అధికారులు వాహనం యజమాని గుర్తించినట్లు మరియు త్వరలోనే అరెస్ట్ చేస్తామని ధృవీకరించారు.	అధికారులు వాహనం యజమానిని గుర్తించారు, త్వరలో అరెస్టు చేయడానికి ఆశిస్తున్నారు.
The Chhatrapati Shivaji statue in the Arabian Sea off the Mumbai coast is referred to as a precedent for the proposed pen memorial.	ముంబయి తీరంలోని అరబియన్ సముద్రలో ఉన్న ఛత్రపతి శివాజీ ప్రతిమ ప్రస్తావిత కాళ్లను ప్రతిమా స్మారకం కోసం మూలకాని చరిత్రంగా పిలుపుతున్నది.	ముంబై తీరానికి సమీపంలో అరేబియా సముద్రంలో ఉన్న ఛత్రపతి శివాజీ విగ్రహాన్ని ప్రతిపాదిత కలమ్పం స్మారక చిహ్నానికి ఒక పూర్వ ఉదాహరణగా సూచించబడుతుంది.	ముంబై తీరం నుండి అరబ్బీ సముద్రంలో ఉన్న ఛత్రపతి శివాజీ విగ్రహం ప్రతిపాదిత కలం స్మారకానికి ముందుమార్గంగా పేర్కొనబడుతుంది.
Several political parties have opposed the pen memorial in the proposed location.	సంస్థలు చెబువారు ప్రస్తావిత స్థలంలో పెన్ స్మారకానికి విరోధం చేసాయి.	కొన్ని రాజకీయ పార్టీలు సూచించిన ప్రదేశంలో కలమ్ స్మారక చిహ్నానికి వ్యతిరేకం ప్రకటించారు.	అనేక రాజకీయ పార్టీలు ప్రతిపాదిత స్థలంలో కలం స్మారకానికి వ్యతిరేకించాయి.
They have not taken into consideration the rainfall data of 2015 or years thereafter. 	వారు 2015 లో లేదా తరువాత ఏ సంవత్సరాల వరకు వర్షాల డేటాను పరిగణించలేదు.	వారు 2015 లేదా ఆ తరవాత సంవత్సరాల వర్షపాతం డేటాను పరిగణనలోకి తీసుకోలేదు.	వారు 2015 లోను తరువాతి సంవత్సరాల్లోను వర్షపాత డేటాను పరిగణలోకి తీసుకోలేదు.
The museum has been equipped with multimedia content, QR codes and holograms.	దాదాపులు, మ్యూజియంను మల్టీమీడియా కంటెంట్, క్యూఆర్ కోడులు మరియు హోలోగ్రామ్‌లతో సజీవీకరించబడింది.	సంగ్రహాలయం మల్టీమీడియా కంటెంట్, QR కోడ్లు మరియు హోలోగ్రామ్‌లతో సుసజ్జితం చేయబడింది.	వారు మ్యూజియం ను మల్టీమీడియా కంటెంట్, క్యూఆర్ కోడ్లు, హోలోగ్రామ్స్ తో సమకూర్చారు.
The ninth phase of the excavations would begin later this month, said officials.	అధికారులు చెప్పారు, ఈ నెల పాదరి తొలి వివరణ యాత్రకారులు ప్రారంభించబోతున్నట్లు.	తవ్వకాల తొమ్మిదవ దశ ఈ నెలలో చివర్లో ప్రారంభమవుతుందని అధికారులు తెలిపారు.	ఈ నెలలో తరువాత ఉత్ఖననాల తొమ్మిదవ దశ ప్రారంభం కానుంది, అధికారులు చెప్పారు.
Mr. Reddy is a close relative of Taraka Ratna's wife Alekya Reddy.	రెడ్డి గారు తారక రత్న భార్య అలేఖ్య రెడ్డి యొక్క సన్నివేశిక బంధువు.	శ్రీ రెడ్డి గారు తారకరత్న గారి భార్య అలేఖ్య రెడ్డి గారి సన్నిహిత బంధువులు.	రెడ్డి గారు తారక రత్న గారి భార్య ఆలేఖ్యా రెడ్డి గారికి సన్నిహితులు.
This betrays an inexplicable hostility towards knowledge creation of all kinds. 	ఇది అన్ని రకాల జ్ఞాన సృష్టికి ఒక అసాధారణ శతృత్వంతో పాటు దాటుతుంది.	ఇది అన్ని రకాల జ్ఞాన సృష్టి పట్ల ఒక అర్ధం కాని శత్రుత్వాన్ని వెల్లడిస్తుంది.	ఇది అన్ని రకాల జ్ఞాన సృష్టికి విచారణీయమైన వైరుధ్యాన్ని బహిర్గతం చేస్తుంది.
The second is what he calls alienation from the process of labour.	రెండవ వస్తువు అతను కార్య ప్రక్రియలో నుండి విముక్తిని అంగీకరించేది అని అతను అందరికి చెబుతుంది.	రెండవది, ఆయన శ్రామిక ప్రక్రియ నుండి దూరమవుతానని పిలుస్తారు.	రెండవది వారు కార్మిక ప్రక్రియ నుండి పరాయణత్వాన్ని అని పిలుస్తారు.
In the process, Marx argued, workers become miserable.	ప్రక్రియ నడుపుతూ, మార్క్స్ అభిప్రాయపడ్డారు, కార్మికులు దుఃఖపడుతారు.	ఆ ప్రక్రియలో, మార్క్స్ వాదించారు, కార్మికులు దయనీయ స్థితికి చేరుకుంటారు.	ఈ ప్రక్రియలో, మార్క్స్ వాదించారు, కార్మికులు దుఃఖితులైనారు.
He asked the people to compare the scale of development in the adjoining Assam during eight years of BJP rule.	అంతర్వర్తిత అసాం లో బిజెపి ప్రభుత్వ ఎనిమిది సంవత్సరాల కాలంలో ప్రగతి యొక్క పైమాను తీసుకువారిగా ప్రజలు అడిగారు.	ఆయన ఆమధ్య అస్సాంలో ఎనిమిది సంవత్సరాలుగా బీజేపీ పాలనలో అభివృద్ధి స్థాయిని పోల్చుకోవాలని ప్రజలను కోరారు.	వారు ఆరు సంవత్సరాల బిజెపి పాలనలో సమీపంలోని అస్సాంలో అభివృద్ధి స్థాయిని పోల్చమని ప్రజలను కోరారు.
The DMK MP also said that the Budget presented by Union Finance Minister Nirmala Sitharaman had neglected sectors such as education, health and agriculture.	డిఎంకే ఎంపీని కూడా జాతీయ ఆర్థరాజ్య మంత్రి నిర్మల శితారమన్ ద్వారా ప్రస్తుతం చేసిన బడ్జెట్ విద్య, ఆరోగ్య మరియు వ్యవసాయ వంటి ఖాళీలను అలపైంది అంటూ కూడా చెప్పింది.	DMK ఎంపీ కూడా కేంద్ర ఆర్థిక మంత్రి నిర్మలా సీతారామన్ గారు సమర్పించిన బడ్జెట్ విద్య, ఆరోగ్యం మరియు వ్యవసాయ వంటి రంగాలను నిర్లక్ష్యం చేశారని అన్నారు.	డీఎంకే ఎంపీలు కూడా యూనియన్ ఫైనాన్స్ మంత్రులు నిర్మలా సీతారామన్ ప్రాతినిధ్యం వహించిన బడ్జెట్ విద్య, ఆరోగ్యం, వ్యవసాయం వంటి రంగాలను విస్మరించిందని చెప్పారు.
The accident took place around 3 p.m. on a State highway close to Korar village.	అపఘాతం కోరర్ గ్రామం సమీపం స్థితించిన రాష్ట్ర రహదారి ప్రకారం 3 గంటల సమయంలో జరిగింది.	ఆ ప్రమాదం మధ్యాహ్నం 3 గంటల సమయంలో కొరార్ గ్రామం సమీపంలోని రాష్ట్ర రహదారిపై జరిగింది.	ఆ ప్రమాదం కొరారు గ్రామం దగ్గర రాష్ట్ర రహదారిపై 3 గంటల సమయంలో జరిగింది.
Both the survivors are being treated at a hospital in Raipur.	రాయపురలో ఆస్తివారులవరిలో రోగిణులు చికిత్స పొందుతున్నారు.	బాధితులు ఇద్దరూ రాయపూర్‌లోని ఒక ఆసుపత్రిలో చికిత్స పొందుతున్నారు.	రెండు బతికినవారు రాయపూర్ లోని ఒక ఆసుపత్రిలో చికిత్స పొందుతున్నారు.
Chief Minister Bhupesh Baghel took to Twitter to express grief over the accident.	ముఖ్యమంత్రి భూపేష్ బాఘేల్ అపఘాతం పై దు:ఖాన్ని వ్యక్తం చేయడానికి ట్విట్టర్ లో వెళ్ళాడు.	ముఖ్యమంత్రి భూపేష్ బఘేల్ గారు ప్రమాదంపై విచారం వ్యక్తం చేయడానికి ట్విట్టర్‌ను ఆశ్రయించారు.	ముఖ్యమంత్రులు భూపేష్ బాఘేల్ ఆకస్మికం పట్ల సంతాపం వ్యక్తీకరించడానికి ట్విట్టర్‌ను ఉపయోగించారు.
The Indian Institute of Technology Madras (IIT-M) Research Park hosted a competition for children.	భారతీయ ఇంజనీరింగ్ సంస్థ (ఐఐటి) మద్రాస్ రిసర్చ్ పార్క్ కనుమ ఒక పోటీకి బాలుల కోసం ఆయోజించింది.	భారతీయ సాంకేతిక సంస్థ మద్రాస్ (ఐఐటీ-ఎం) పరిశోధనా పార్క్ వారు పిల్లల కోసం ఒక పోటీని నిర్వహించారు.	భారతీయ సాంకేతిక విశ్వవిద్యాలయం మద్రాస్ (ఐఐటి-ఎం) పరిశోధనా పార్క్ పిల్లల కొరకు పోటీని నిర్వహించింది.
"External affairs minister S Jaishankar on Tuesday expressed concern over the attack on a Hindu temple in Canada, describing the incident as ""deeply concerning."	"బహిరాగామి కార్యాలయ మంత్రి ఎస్ జయశంకర్ మంగళవారం కెనడాలో ఒక హిందూ దేవాలయంపై దాడి జరిగినందుకు భారతీయ ప్రతినిధులు ఆందోళన వ్యక్తం చేశారు, ఈ ఘటనను ""ఆళ్లింగా ఉంది"" అని వివరించారు."	"విదేశాంగ మంత్రులు ఎస్. జైశంకర్ మంగళవారం కెనడాలోని హిందూ దేవాలయంపై జరిగిన దాడికి గాను ఆందోళన వ్యక్తం చేస్తూ, ఈ ఘటనను ""గంభీరమైన ఆందోళనకరమైనది""గా పేర్కొన్నారు."	"విదేశీ వ్యవహారాల మంత్రులు ఎస్ జైశంకర్ మంగళవారం కెనడాలో హిందూ దేవాలయంపై జరిగిన దాడిపై ఆందోళన వ్యక్తం చేసి, ఈ సంఘటనను ""చాలా ఆందోళనకరం"" అని వర్ణించారు."
Modi condemns violence after Canada temple inciden.	మోడీ కెనెడా ఆలయ ఘటనతో సంతాపం వ్యక్తం చేసారు.	మోదీ గారు కెనడా ఆలయం ఘటన అనంతరం హింసను ఖండించారు.	మోదీ గారు కెనడా ఆలయ సంఘటన తర్వాత హింసను ఖండిస్తున్నారు.
Mr Nijjar had been a vocal supporter of the Khalistan movement and publicly campaigned for it.	నిజ్జర్ గారు ఖాలిస్తాన్ ఆందోళనకు ప్రత్యక్ష మధ్యపనాలు చేసిన మరియు ప్రజాస్వామ్యంలో ప్రచారం చేసినట్లు ఉండారు.	నిజ్జర్ గారు ఖలిస్తాన్ ఉద్యమానికి బహిరంగంగా మద్దతు తెలిపి, దాని కోసం ప్రచారం చేశారు.	శ్రీ నిజ్జార్ గారు ఖలిస్తాన్ ఉద్యమానికి సార్వజనీనంగా మద్దతు ప్రకటించి, దానికోసం ప్రజా ప్రచారం చేశారు.
Bangladesh steps up repayments to Adani to avoid power supply cu.	బంగ్లాదేశ్ శాసనాలు వల్ల విద్యుత్ సరఫరాల కోసం అదానికి తిరిగి చెల్లించడానికి ప్రయత్నిస్తున్నాయి.	బంగ్లాదేశ్ విద్యుత్ సరఫరాలో అంతరాయం వస్తే నివారించడానికి అదానీకి చెల్లింపులు వేగవంతం చేస్తున్నారు.	బంగ్లాదేశ్ అధికారులు అదానీకి చెల్లింపులను పెంచుతున్నారు ఆవిధంగా విద్యుత్ సరఫరా సమస్యలను నివారించుకోవడానికి.
The country is already suffering from increased power shortages in rural areas.	దేశం ఇప్పుడు గ్రామీణ ప్రాంతాల్లో విద్యుత్ కొంత లెక్కలు పెరుగుతున్నట్లుగా ఇచ్చింది.	దేశం ఇప్పటికే గ్రామీణ ప్రాంతాల్లో పెరిగిన విద్యుత్ లోపాల వల్ల బాధపడుతోంది.	దేశం ఇప్పటికే గ్రామీణ ప్రాంతాల్లో పెరిగిన విద్యుత్ లోపాలను అనుభవిస్తున్నది.
Officials said 44 people were on board when the driver lost control and the bus fell into a 50m-deep ditch in Marchula, located in the state’s Almora district.	అధికారులు చెప్పారు డ్రైవరు కంట్రోల్ పోయినప్పుడు బస్ మార్చులలో పడిపోయింది, ఆల్మోరా జిల్లాలో ఉండిన మార్చుల రాజ్యంలో 50 మీటర్ల ఉండే గడ్డికి పడిపోయిన సమయంలో 44 మంది ప్రయాణికులు ఉండారని చెప్పారు.	అధికారులు చెప్పినదాని ప్రకారం, డ్రైవర్ నియంత్రణ కోల్పోయినప్పుడు 44 మంది బస్సులో ఉన్నారు మరియు బస్సు రాష్ట్రంలోని అల్మోరా జిల్లా లో ఉన్న మార్చులాలో 50 మీటర్ల లోతైన లోయలో పడింది.	అధికారులు చెప్పినట్లు మార్చులాలోని అల్మోరా జిల్లాలో ఉన్న 50 మీటర్ల లోతున్న కందకంలో బస్సు పడిపోయినప్పుడు డ్రైవరు నియంత్రణ కోల్పోయినప్పుడు బోర్డులో 44 మంది ఉన్నారు.
Uttarakhand's Chief Minister Pushkar Singh Dhami has also announced financial assistance for the victims and their families.	ఉత్తరాఖండ్ ముఖ్యమంత్రి పుష్కర్ సింగ్ ధామి కూడా ఆపదాలకు మరియు వారి కుటుంబాలకు ఆర్థిక సహాయం ఘోషించారు.	ఉత్తరాఖండ్ ముఖ్యమంత్రి పుష్కర్ సింగ్ ధామి గార్లు బాధితులు మరియు వారి కుటుంబాల కోసం ఆర్థిక సహాయం ప్రకటించారు.	ఉత్తరాఖండ్ ముఖ్యమంత్రులు పుష్కర్ సింగ్ ధామీలు కూడా బాధితులకు మరియు వారి కుటుంబాలకు ఆర్థిక సహాయాన్ని ప్రకటించారు.
Our scientists used it as an incentive to develop their own technology.	మా వైజ్ఞానికులు వారు తమ స్వం సాంకేతికం మెరుగుదీస్తున్నారు.	మన శాస్త్రవేత్తలు తమ సొంత సాంకేతికతను అభివృద్ధి చేయడానికి దానిని ప్రోత్సాహకంగా ఉపయోగించారు.	వారి శాస్త్రవేత్తలు దాన్ని తమ స్వంత సాంకేతికతను అభివృద్ధి చేయడానికి ప్రోత్సాహకంగా ఉపయోగించారు.
Mylswamy Annadurai, chief of India’s first and second Moon missions and Mars mission, told the BBC that Isro employs far fewer people and pays lower salaries, which makes Indian projects competitive.	భారతదేశంలో మొదటి మరియు రెండవ చంద్ర మిషన్ల మరియు మంగళ మిషన్ల కార్యదర్శి మైల్స్వామి అన్నాదురాయ్ బీబీసీకి చెప్పినట్లు, ఐఎస్రో చాలా తక్కువ ప్రముఖులను నియమిస్తుంది మరియు తక్కువ జీతాలు పొందటం భారతీయ ప్రాజెక్ట్లను కంపెటిటివ్ గా చేస్తుంది.	భారతదేశం యొక్క మొదటి మరియు రెండవ చంద్ర మిషన్లతో పాటు మార్స్ మిషన్‌కు నాయకత్వం వహించిన మైలస్వామి అన్నదురై గారు, ఇస్రో తక్కువ మంది ఉద్యోగులను నియమించుకుంటుందని మరియు తక్కువ జీతాలు చెల్లిస్తుందని, దీని వల్ల భారతీయ ప్రాజెక్టులు పోటీగా ఉంటాయని బీబీసీకి తెలియజేశారు.	మైల్స్వామి అన్నదురై, భారతదేశం యొక్క మొదటి మరియు రెండవ చంద్ర మిషన్లు మరియు మార్స్ మిషన్ యొక్క అధిపతులు, బిబిసికి చెప్పారు కి ఇస్రో చాలా తక్కువ మంది ఉద్యోగులను నియమిస్తుంది మరియు తక్కువ జీతాలను చెల్లిస్తుంది, ఇది భారతీయ ప్రాజెక్టులను పోటీతత్వంలో ఉంచుతుంది.
Ex-district president of Bajrang Dal Gurgaon held for shooting at Gurgaon man.	గుర్గావులో ఒక గుర్గావు మనిషిని గుండు చేసిన బజ్రంగ్ దళ్ గుర్గావు జిల్లా ప్రధానిని ఎంపికగొట్టినాడు.	గురుగ్రామ్ వ్యక్తిపై కాల్పులు జరిపినట్లు ఆరోపణలతో బజరంగ్ దళం మాజీ జిల్లా అధ్యక్షులను గురుగ్రామ్ పోలీసులు అరెస్ట్ చేశారు.	బజరంగ్ దళ్ గుర్గావ్ మాజీ జిల్లా అధ్యక్షులు గుర్గావ్ వ్యక్తిపై కాల్పులు జరిపినందుకు అరెస్టు చేయబడ్డారు.
The legendary Bob Khathing led the expedition to peacefully integrate Tawang into India.	ప్రముఖ బాబు ఖాథింగ్ తన నేతృత్వంలో తవాంగ్ ను భారతదేశంలోకి శాంతిగా ఏకీకరించడానికి అభియానం నడుస్తుంది.	ప్రముఖ బాబ్ ఖాథింగ్ గారు తవాంగ్‌ను భారతదేశంలో శాంతియుతంగా కలిపే దౌత్యయానం నడిపించారు.	ప్రసిద్ధ బాబ్ ఖాతింగ్ గారు భారతదేశంలో తావాంగ్ ను శాంతియుతంగా విలీనం చేసే ప్రయాణాన్ని నడిపించారు.
In 1939, after the Second World War broke out, Khathing joined the Indian Army and got an Emergency Commission as an officer.	1939 లో, దద్దుకునిచ్చిన తర్వాత ఖతింగ్ భారత సేనలో చేరి, ఆధునిక పోస్టుకు ఆపరేషనల్ కమిషన్ పొందాడు.	1939లో, ద్వితీయ ప్రపంచ యుద్ధం ప్రారంభమైన తర్వాత, ఖాథింగ్ భారత సైన్యంలో చేరి, అధికారి గా అత్యవసర కమిషన్ పొందారు.	1939లో రెండవ ప్రపంచ యుద్ధం ప్రారంభమైన తరువాత, ఖాతింగ్ భారతీయ సైన్యంలో చేరి అధికారులు వారికి జరూరీ కమిషన్ ఇచ్చారు.
At the end of the Second World War, the Emergency Commissioned officers in the Army were demobilised.	ద్వితీయ ప్రపంచ యుద్ధం ముగిసి, సేనలో ద్రుత కార్యకారులు పరిహరించబడ్డారు.	రెండవ ప్రపంచ యుద్ధం ముగిసిన తరువాత, సైన్యంలో ఉన్న ఎమర్జెన్సీ కమిషన్డ్ అధికారులను డీమోబిలైజ్ చేశారు.	రెండవ ప్రపంచ యుద్ధం ముగింపులో, సైన్యంలోని జరూరీ కమిషన్డ్ అధికారులు విడుదల చేయబడ్డారు.
Most of the senior cricketers were far from their best, especially against New Zealand.	అధికారులు, అధికారులు ముఖ్యంగా న్యూజిల్యాండ్ యొక్కనుండి వచ్చినదిని గమనించేరు.	ముఖ్యంగా న్యూజిలాండ్‌ వ్యతిరేకంగా, చాలా మంది సీనియర్ క్రికెటర్లు తమ ఉత్తమ స్థితి నుండి దూరంగా ఉన్నారు.	ఎక్కువ సీనియర్ క్రికెటర్లు వారి ఉత్తమం నుండి దూరంగా ఉన్నారు, ప్రత్యేకించి న్యూజిలాండ్ పై.
